қараю	V
бекзат	N
нұрлану	V
адамшылық	N
пырақ	N
Жәнібек	N
венгрия	N
жігерлену	V
топтама	N
майор	N
елеуреген	A
күйік	N
Рим	N
бағу	V
леген	N
одағай	N
қырау	N
сығымдау	V
шай-пұл	N
аужарлық	N
қотыр	N
сәлем	INTJ
ұялту	V
сөзуар	A
кәмпит	N
конгресс	N
қоныс	N
публицист	N
діни	A
өтелу	V
алдымен	ADV
қаратал	N
ядро	N
бытықы-шытықы	N
жүгіндіру	V
антология	N
эпитет	N
алтау	NUM
биология	N
тиіс	PART
қалтқы	N
өсекші	N
локомотив	N
есепшот	N
өтініш	N
күндес	N
самбырлау	V
сойқан	A
айқайшы	N
шылапшын	N
Біжікен	N
Тоғжан	N
климат	N
кесте	N
бүліну	V
білеулену	V
арпалысу	V
қыли	A
насос	N
түзетілу	V
донор	N
сыйым	N
жартас	N
интервенция	N
желік	N
қатаю	V
көксау	N
көбінесе	A
менікі	PRO
былғау	V
қайсар	A
демобилизация	N
көркем	A
бұрмалау	V
тепе-теңдік	N
анықталу	V
почта	N
жарылыс	N
ауысу	V
еліктеген	A
әк	N
Мағрипа	N
алжир	N
дәруіш	N
соңғы	A
жартылау	V
астапыралла	INTJ
арыстандай	A
түтету	V
тыпыршу	V
сарапшы	N
түрме	A
елші	N
әуелету	V
намазшам	N
алаң-елең	N
кеңіту	V
полиция	N
кестелеу	V
алыс-жақын	A
шоқ	N
қайрайтын	A
шежіреші	N
қын	N
әсерлену	V
шекаралық	A
өлім-жітім	N
ерегіс	N
абыройсыздық	N
іңкәрлік	N
арамза	A
сай	N
үйірсек	A
қарапайым	A
үлгі	N
ырғақтау	V
өздігінше	ADV
үндесу	V
ісу	V
бикеш	N
жадынама	N
құрсақ	N
сымбат	N
тұс	N
жаратылыстану	N
киім	N
бәсеңдеу	V
дарын	N
қаю	V
бөлшектену	V
шарт-шұрт	IW
өнеркәсіп	A
шатасу	V
ылғалдау	V
айбарлы	A
табансыздық	N
жаншу	V
шота	N
невропатолог	N
Нұрмұхан	N
аң	N
қойыртпақтану	V
тиістісі	N
бронхит	N
асығыс-үсігіс	N
ойланбастан	ADV
психика	N
күзету	V
толығу	V
быт-шыт	ADV
рекорд	N
келіс	N
сәлемдесу	V
оптимистік	A
гүрсіл	N
миллиардер	N
адырлы	A
тірідей	ADV
небәрі	PRO
беріктік	N
зәредей	A
деңгейлесу	V
елес	N
төстеу	V
шәлі	N
тарғыл	N
тапқырлық	N
борық	N
қалшию	V
амандасу	V
шерлену	V
абиыр	N
айтулы	A
батыр	N
қай-қайсысы	A
алқым	N
таңдаулы	A
сөзуарлық	N
коммуникация	N
сауға	N
батыр	A
жас	A
сүйемдеу	V
күйзелу	V
көрімдік	N
Батухан	N
белгіленген	A
белбеу	N
жыру	V
прокурор	N
беттік	N
тоқпақтау	V
жалтақ	A
раушан	N
алпыс	NUM
қаталау	V
қарғу	V
құраушы	N
жаңбыр	N
бұраңдау	V
тынбау	V
азық	N
өмірбақи	ADV
тоқаш	N
саяқ	A
сүйеуші	N
әңкі-тәңкі	N
шалқаю	V
жылжыту	V
тест	N
безер	A
шалағайлық	N
шоқыту	V
тақпақ	N
қараша	N
қуат	N
Байбек	N
Әбдіразақ	N
Таман	N
жаһан	N
кәне	INTJ
кідірту	N
сыртынан	ADV
фонограмма	N
кәсіптік	A
ультиматум	N
айтыс	N
дерттілік	N
растық	N
директор	N
тексеру	V
мәнерлілік	N
тұтықпа	N
айлық	N
подполковник	N
Нұралы	N
қайың	N
шіркін	INTJ
ыс	N
өлмейтін	A
тінту	V
ат	N
інжір	N
желпуіш	N
документ	N
Құдабай	N
ерке-шора	A
лингвистикалық	A
тұқым	N
жазық	A
ою-өрнек	N
құралу	V
селбесу	V
түрткі	N
мейірлену	V
тойғызу	V
ықыластану	V
сома	N
патенттеу	V
ақиқат	N
иленген	A
педиатр	N
тыным	N
сусын	N
көңілділік	N
топас	A
төлеу	V
кәсіпкер	N
рухтану	V
топырлау	V
Арғын	N
сорлылық	N
ұқсату	V
үлпілдек	A
біртұтас	A
Москва	N
маужырау	V
төлеу	N
жұмырлану	V
ситуация	N
құрысу	V
Ақшоқы	N
сасу	V
перзентхана	N
сусындау	V
тұтамдау	V
шақылдау	V
барабар	A
төңкеру	V
кәні	INTJ
қалжыңдау	V
тыраңдау	V
сезімталдық	N
кемік	N
күнкөру	V
мүңку	V
барлаушы	N
қақпан	N
жалғызсырау	V
ылаң	N
буын	N
егіз	N
сөл	N
шеттеу	V
палуба	N
педагог	N
обалсыну	V
ұшқын	N
тұтату	V
ілгеріде	ADV
әдет-ғұрпы	N
фразеология	N
арабтар	N
қауым	N
байқау	V
мөлшер	N
неліктен	PRO
алмұрт	N
жалшылық	N
ойыншы	N
саптану	V
иллюстрация	N
қалып	N
Досбол	N
діндар	A
құрылысшы	N
айран	N
сары	N
сенатор	N
кіп-кішкентай	A
қиындату	V
жарамсақ	A
жесір	N
майысу	V
ұқсастық	N
ойнақы	A
тері-терсек	N
қазалы	N
жаныштау	V
бәтес	N
мал-мүлік	N
феномен	N
өзгеше	A
олақ	A
романтизм	N
мемлекет	N
реттеу	V
сыртқы	A
қарылу	V
қаза	N
іні	N
күллі	PRO
балдырлау	V
әуежай	N
үргізу	V
арлан	N
мамандану	V
тәбет	N
аққу	A
сапы	N
құйын	N
тұлғалы	A
көлгірлік	N
тұтығу	V
қисайған	A
қараңдау	V
тай	N
жақтау	V
пенсионер	N
итаршы	N
ауқат	N
айлашыл	A
сүйіну	V
тағайындау	V
шабақ	N
Федоров	N
жұрт	N
кеңдік	N
аударушы	N
қағып-сілку	V
намысқор	A
қорлану	V
озық	A
қылды	A
космос	N
қорқыту	V
босаңсу	V
бүлдіршін	N
республика	N
магнитофон	N
пішін	N
шеміршек	N
сылау	V
тиімді	A
тұлдану	V
ғұлама	A
полк	N
бидон	N
өңі	N
уақтылы	ADV
біржолата	ADV
философиялық	A
безеу	V
ақтық	A
адым	N
будан	N
даралау	V
Торсан	N
вольт	N
заңғар	A
концентрация	N
аңғар	N
жеңіл	A
қолтаңба	N
мәңгібақи	ADV
амандық-саулық	N
жайын	N
бюро	N
шығару	V
ауызша	ADV
шапағат	N
жалғастырушы	N
құрсау	N
өжет	A
маска	N
сарышұнақ	N
бейім	A
ірімшік	N
мыңдаған	NUM
аға-жеңге	N
асығыс	N
балалы-шағалы	A
жөн	A
жылдан-жылға	ADV
дауыстау	V
сыздауық	N
барқыт	N
үй-жай	N
қатал	A
кесіртке	N
той-томалақ	N
дауыстап	V
майка	N
әлемет	N
қарғы	N
наразылық	N
мұнтаздай	A
дамылсыз	N
азбан	N
өнім	N
аккорд	N
ұстамдылық	N
миллиметр	N
шөміш	N
қаймақ	N
Күрлеуіт	N
өткенде	ADV
итсигек	N
тете	N
әлек	N
салғыласу	V
тиек	N
шалғайда	ADV
әлжуаз	A
конструкция	N
ишара	N
түйісу	V
методология	N
еркек	N
елеулі	A
айдарлы	A
Нұрбике	N
телміру	V
жекпе-жек	N
тұсау	N
Асад	N
туыстық	N
рауандау	V
Шондығұл	N
Жағалбайлы	N
федерация	N
елестеу	V
адамдық	N
ұйым	N
керней	N
қасіретті	A
кейіс	N
сұрау	V
мәселен	PARENTH
бәрібір	ADV
арқылы	ADV
жолшыбай	ADV
қарыштау	V
компонент	N
ұрланған	A
тізгіндеу	V
сәрсенбі	N
алаң	N
жұтқыншақ	N
органикалық	A
араласу	V
тегене	N
тасқын	N
нас	N
нас	A
формула	N
профилактикалық	A
Кәлен	N
ұтылу	V
еділ	N
персонаж	N
жұдырық	N
дизель	N
есік	N
үсті-басы	N
майдандас	N
қапсағай	A
қызбалық	N
аңғал	A
кекірік	N
төртеу	NUM
трансформация	N
қайсыбір	A
анықтасу	V
самалдау	V
бейшара	A
желіс	N
жолықтыру	V
орындық	N
даңғаза	N
тию	V
Айына	N
сіңіру	V
сахна	N
жылпылдау	V
әншілік	N
торпақ	N
қиял	N
мес	N
шошаю	V
уайымдау	V
басмашы	N
теңбіл	A
аяқтау	V
қапылыс	N
іріктеу	V
қарақшылық	N
қоқырсыған	A
жетімсіреу	V
жалтыр	A
шегендеу	V
зат	N
үй	N
дудар	A
әке	N
бәйге	N
жолбасшы	N
тамшылау	V
Салидат	N
түгелімен	N
Хиуа	N
тұсаулы	A
бездіру	V
арбалу	V
желбегей	N
аздаған	A
үтіктеу	V
ашырқану	V
қарамай	N
тұрғылықты	A
жылылық	N
шығым	N
қарақат	N
жан-жануар	N
желігу	V
қатынас	N
ылғи	ADV
Путин	N
бәлкім	PARENTH
Сейхун	N
тән	A
неғып	PRO
мерейтой	N
қорықпау	V
жеделдеу	V
тездету	V
масайрау	V
күнде	N
түсінбеушілік	N
өз-өзінен	ADV
ойлаушы	N
тіркеу	V
кермек	A
имек	A
жұп-жұмсақ	A
диалектика	N
температура	N
символ	N
балаған	N
итеру	V
қоқилану	V
база	N
өкшелей	ADV
базис	N
Кәукер	N
жүйелендіру	V
ауырлаған	A
таусылмайтын	A
қарамастан	ADV
дәрменсіздік	N
жіктелу	V
аласталу	V
қаумалау	V
айбар	N
тосқауылдау	V
шыныққан	A
нөкер	N
француз	N
бірталай	A
момындық	N
салық	N
формант	N
іле-шала	ADV
әсіресе	N
миномет	N
хайуандық	N
әлпет	N
қайсыбіреу	N
тұрақсыз	A
сыпыра	N
ұштық	N
үйме-жүйме	N
туралық	N
аулақтау	N
аңша	ADV
құмарлық	N
шақа	N
диспансер	N
кернеген	A
аулақтау	V
боршалау	V
қамшылау	V
тілу	V
жете	ADV
өзен	N
тапсыру	V
турист	N
қырғи-қабақ	N
Сарыарқа	N
тасырлау	V
қаламақы	N
философия	N
нарын	N
жоғарылық	N
шен	N
дивизион	N
миссия	N
санаулы	A
ішу	V
ойластыру	V
кепілдік	N
базар	N
шошақ	A
дүбірлеу	V
қашқын	N
қадір-қасиет	N
арқалық	A
арасан	N
жасқаншақ	A
қағаз	N
марш	N
баға	N
мейлі	PARENTH
еркексу	V
мұрсат	N
тәрізді	A
балалы	A
ертеңгі	A
тілдеу	V
жетерлік	A
тосырқау	V
қызғылттану	V
жүйек	N
дейін	CONJ
кекету	V
жану	V
Қостанай	N
жарақ	N
ел	N
көзілдірікті	A
кішілік	N
радиология	N
ыңғайлы	A
топшылау	V
Қази	N
құттықтау	V
жалтылдау	V
тұнық	A
шиеленіс	N
жемқорлық	N
бұлғақ	N
Шағай	N
композиция	N
қауіптенбеу	V
сүт	A
алмас	N
кекіру	V
есептеу	V
бор	N
мүгедектік	N
сергу	V
дым	N
өнеркәсіптік	A
түнеріңкі	A
арамдық	N
айқасу	V
абысын-ажын	N
мерей	N
өзін-өзі	ADV
біржолғы	A
оңбағандық	N
жүк	N
қанқұмар	A
улану	V
жолсерік	N
Дутов	N
алаяқ	N
шіру	V
информация	N
бұрым	N
губерния	N
әділ	A
ерігу	V
музыкалық	A
шапқын	N
керіс	N
қарақұйрық	N
Мүсіреп	N
оқырану	V
әткеншек	N
папаха	N
жерүй	N
реанимация	N
шайқаңдау	V
немере	N
гармония	N
анық	A
жаппа	N
ене	N
құпиялау	V
тауық	N
дәреже	N
лайықсыз	A
патриоттық	A
шаршау	V
зәбір	N
әрқилы	A
бүркемелеу	V
ерттеу	V
әбігерлену	V
тақуалық	N
жүгірткі	N
өртеу	V
ертеңгісін	ADV
хабарлама	N
өркештену	V
қаталдану	V
ақта	N
азырақ	ADV
бет-аузы	N
оңалту	V
қайталану	V
қосшы	N
сорлы	A
жануар	N
дәмелендіру	V
жай-күй	N
ұлпа	A
қайқы	A
ақ	A
өксу	V
әрқалай	ADV
қою	A
бұзаубас	N
қартайған	A
тасаттық	N
баласыздық	N
лыпылдау	V
Бүркітбай	N
қанжар	N
қою	V
фототілші	N
келте	A
көкбазар	N
әкелік	N
қиыншылық	N
асып-тасу	V
халық	N
масса	N
ары-бері	ADV
олақтық	N
улы	A
сүйемелдеу	V
күшену	V
атлас	N
саялы	A
жеңілу	V
алдан	ADV
белуар	N
лагерь	N
папирос	N
квалификациялау	V
бұранда	N
бау	N
басушы	N
мекен-жай	N
ауыл-аймақ	N
Әбілқайыр	N
сүйгіштік	N
ентелеу	V
патша	A
леп	N
Ақан	N
интеллект	N
Қанипа	N
шудалау	V
даярлайтын	A
тереңінен	N
Тұрлыбек	N
баладай	N
күмәндану	V
шұбау	V
талпыну	V
тышқан	N
мамырлау	V
пырыл	N
желдену	V
сіңлі	N
о	INTJ
имам	N
үшбұрыш	N
торлау	V
ана	N
жауыздық	N
Қарасай	N
еңбектеу	V
сауық	N
айтқысыз	A
үйез	N
жылқы	N
езу	N
шаптырым	N
аштық	N
жергілікті	A
сұмдық	N
сыбдырлау	V
тауар	N
арена	N
езу	V
ансамбль	N
қария	N
полюс	N
жөнелту	V
собалақ	A
үш	NUM
емші	N
мықтылық	N
сақал-мұрт	N
трагедиялық	A
нәпсі	N
алдияр	N
демікпе	N
құтқарушы	A
шатақ	N
құтқарушы	N
тәкаппарлану	V
ұлт	N
арық	A
әлгі	PRO
Қаншайым	N
клетка	N
кею	V
сыпайылық	N
күшік	N
секілді	ADV
қайқаю	V
бері	ADV
диаметр	N
Лып	N
ой	INTJ
преферанс	N
қару-жарақ	N
тұмса	A
артиллерия	N
сіздікі	PRO
маңызды	A
нәтижелі	A
лимит	N
енеу	V
нанғыш	A
қомдану	V
тыртық	N
баяндауыш	N
үш-үштен	NUM
ерік	N
айтушы	A
партнер	N
қысқаша	ADV
қанішерлік	N
шошақтау	V
Украина	N
ұстасу	V
ілтипаттылық	N
сенат	N
тыю	V
тары	N
мезгіл	N
келу	V
қазба	N
хақы	N
ауыт	N
бекетші	N
кооперация	N
парық	N
жүгіру	V
хаттама	N
тықыр	A
ашылыңқырау	V
саябырлау	V
жан-жақтылық	N
көлеңкелену	V
қарсақ	N
қазақша	N
гауһар	N
қайраткер	N
өлмелі	A
мұңдас	N
мәңгілік	A
армандай	A
күнелту	V
шашалу	V
ілгерілеу	V
безелу	V
алқымдау	V
есалаң	A
кінәлау	V
алабажақ	A
ұра	N
пәлендей	N
жалтару	V
шөлейт	N
сулық	N
баптау	V
уақ	A
тұлға	N
кісендеу	V
негіз	N
бағалы	A
теңдік	N
ашыту	V
разы	A
біраз	ADV
молдық	N
жуу	V
Жанпейісов	N
ызылдау	V
мүләйім	A
қызылша	N
алюминий	A
мүшкіл	A
тықырлату	V
өнеге	N
бәсе	INTJ
дүлдүл	A
өшу	V
монумент	N
құдық	N
құн	N
сенбілік	N
шарық	N
минимум	N
араша	N
беттеу	V
блиндаж	N
арал	N
Ұлықбек	N
бәйтерек	N
қақ	N
пулемет	N
арна	N
әскер	N
жара	N
шыбықтау	V
өзінен-өзі	ADV
мұқыл	A
Әбілмәмбет	N
күрсілдеу	V
мәңгі	A
осы	PRO
ірілеу	V
сарылу	V
ескеру	V
түрлендіру	V
тапшылық	N
мына	PRO
түрлендіру	N
үйірілту	V
орақ	N
үгіт	N
ойша	ADV
орташа	ADV
ішкөйлек	N
мүсін	N
құтқару	V
қозғалыс	N
зарлау	V
мархабат	N
жезтырнақ	N
қыруар	A
процесс	N
қайнаға	N
құрастыру	V
іріктелген	A
орман	N
күлегеш	N
редакция	N
арабша	ADV
ферма	N
басыр	N
тұтқын	A
тауқымет	N
түзелу	V
процент	N
қажырлы	A
инабатты	A
өміршең	A
жақтаушы	N
тұтқын	N
орындау	V
жуандау	V
ресурстар	N
бақай	N
үзілді-кесілді	N
төре	N
бірауызды	A
илігу	V
хандық	N
бейресми	A
мекиен	N
бағдарлама	N
Дәулетұлы	N
соқпақ	N
байпақ	N
бейімделген	A
жағалау	V
ғаламат	A
жып-жылы	A
алшын	N
барон	N
сейілдеу	V
қатқақ	N
әзірлік	N
келешегі	N
шашақ	N
жанжал	N
өркениет	N
балама	N
бүйту	V
ұйқысырау	V
ыңғайлау	V
тайсалмай	A
Сәлима	N
науқан	N
зеректік	N
айла	N
қоқан-лоққы	N
босаға	N
ізденуші	N
қалжың	N
шындық	A
ұры	N
сүйкімділік	N
сабырсыздану	V
алмастыру	V
материалдық	A
жан	N
білгендік	N
компартия	N
қармалау	V
бұралаң	A
нақыл	N
бірсыпыра	PRO
летчик	N
желпу	V
конституция	N
арсалаңдау	V
Байдәулет	N
қойма	N
қалқу	V
ұшы-қиырсыз	A
дүрсіл	N
азулы	A
дания	N
изеу	V
шәуілдеу	V
ноян	N
университет	N
министр	N
желтоқсан	N
ағайын	N
жекжат	N
қамыс	N
кесепат	N
аурушаңдық	N
шабарман	N
семіздік	N
бұзылғандық	N
шейх	N
кібіртіктеу	V
миуа	N
зәулім	A
жүз	N
өркендеу	V
акционерлік	A
веложарыс	N
аңқаулық	N
толқындану	V
шіміркену	V
сырылдау	V
кектесу	V
дүниетаным	N
сусар	N
масқаралау	V
жұма	N
жұмыссыздық	N
оқшаулау	V
симфония	N
жұлын	N
қандыру	V
Біржан	N
есеп-қисап	N
сездірмеу	V
қалыңдық	N
жарым-жарты	A
тоздыру	V
докторлық	A
қайраткерлік	N
арналу	V
ору	V
таяну	V
қамшат	N
тыншу	V
даярлау	V
ассамблея	N
ниет	N
көңілсіздену	V
шерлі	A
алақан	N
көксеу	V
тәлтіректеу	V
инспекция	N
таразылау	V
адақтау	V
бағыт	N
мерзім	N
тыржыңдау	V
шапшаң	A
келгіштеу	V
фойе	N
ұзынша	A
тираж	N
шаншу	V
ер	N
отаншыл	N
ер	A
зияндылық	N
илікпеу	V
игеруші	A
дамбалшаң	A
адьютант	N
мүлтік	N
жүктеме	N
иек	N
майдандасу	V
жуас	A
мәртебе	N
жастар	N
мүдделілік	N
тұтас	A
акцент	N
оқ	N
тажал	N
Қайырбекова	N
ілгіш	N
рецептор	N
шынайы	ADV
жұмылдыру	V
жәбірленуші	N
ұстау	V
автоматтандырылу	V
кірлету	V
лингвистика	N
теңбе-тең	ADV
жарықшақтану	V
диалектология	N
ұғым	N
тынышсыздану	V
салғырттық	N
шыңдау	V
ептілік	N
бүкеңдеу	V
германия	N
концепция	N
мандымды	A
күзет	N
салақтау	V
қайдан	N
әуестік	N
құнан	N
жетектеуші	N
суалу	V
нысана	N
қонақтау	V
шалма	N
шұбыру	V
өркөкірек	A
ыңыршақ	N
рас	ADV
цистит	N
шыдамдық	N
ұйыту	V
қабынуы	N
ыдырау	V
грек	N
молығу	V
қожалақ	A
базарлық	N
аттану	V
керу	V
орнықсыз	A
жасты	A
кәдімгідей	ADV
шүріппе	N
өңделген	A
мейлінше	ADV
пассив	N
лицензия	N
сырғыту	V
алғашқыда	ADV
ауырлық	N
қанағат	N
ауызсу	N
жұмақ	N
вакцина	N
бүкілхалықтық	A
ағартушы	A
уағдаластық	N
жасыру	V
қоғамдастық	N
балуан	N
қорек	N
қытырлақ	A
Тасболат	N
советтену	V
мыңжапырақ	N
айтыс-тартыс	N
шалғын	N
алдамшы	A
қолма-қол	ADV
суару	V
булықтыру	V
реттілік	N
секемшіл	A
әділеттілік	N
бөлімше	N
өсу	V
журнал	N
тұжырымдама	N
жеу	V
батырсыну	V
Темірлан	N
ынжық	A
айттау	V
ұл	N
азғана	N
қауға	N
киіз	N
тепкілеу	V
қазына	N
сиықсыз	A
вокалдық	A
елемеу	V
етпетінен	ADV
Ақбала	N
синоним	N
айқара	N
бике	N
тітіркену	V
вожатый	A
көргенді	A
сірі	N
қақпайлау	V
базына	N
карточка	N
алыстан	ADV
ұзынды-қысқалы	A
кәсіподақ	N
түңілу	V
повесть	N
аласұру	V
ескіру	V
Тараз	N
айнытпай	N
ақша	N
шошаңдау	V
шетелдік	A
шетелдік	N
созылу	V
киіз	A
азарлау	V
мән	N
ұлт-азаттық	A
гарем	N
шешім	N
жүріп-тұру	V
соңы	N
бульвар	N
сыдыру	V
жаңғалақ	A
түгендеу	N
замана	N
екіжүзді	A
франция	N
хайуан	N
тек	ADV
төрт	NUM
қайрылу	V
орай	N
төмпештеу	V
дайын	A
айқындық	N
қырғауыл	N
ұйқы-тұйқы	N
каталог	N
ойсылқара	N
витамин	N
күйлену	V
баспа	N
алақандау	V
лақ	N
шалқасынан	ADV
дөрекі	A
Ғафиз	N
трилогия	N
марапат	N
қарама-қайшылық	N
зерделі	A
азия	N
жортуылдау	V
шаңдату	V
томсару	V
бұқара	N
ән-би	N
желі	N
қиралаңдау	V
ажырау	V
маңыздылық	N
ептеп	ADV
көбік	N
аш	A
предикатив	N
елеңдеу	V
жойғызу	V
жүн	N
жұмалық	A
тоқсан	N
көшпенді	N
Ақмола	N
арттан	ADV
ішкі	A
басымдылық	N
кіндік	N
олай	PRO
әкету	V
бәсекелесу	V
алфавит	N
қораздану	V
ожарлық	N
жарайтын	A
теңдессіз	A
кесек	N
газ	N
мықты	A
автожол	N
плакат	N
салушы	N
бай	N
құбылыс	N
түлкі	N
тәуелдеу	V
бай	A
жарымес	A
атқамінер	N
талқан	N
қазына-мүлік	N
стандарт	A
болжам	N
сәлемет	A
шәрбат	N
баяулату	V
қазақы	A
әрең	ADV
бронды	N
тышқақ	N
қабыл	N
абстракт	N
зират	N
шипалы	A
жағымсыз	A
кішірею	V
бауырластық	N
дүркін-дүркін	ADV
тариф	N
қабілеттілік	N
қастасу	V
мұрат	N
керілдесу	V
әскербасы	N
еңбектеп	N
марс	N
жирендіру	V
саза	N
бейбіт	A
атшабар	N
декорация	N
ойрат	N
күйдіретін	A
дұрыстық	N
қарлығу	V
маңдай	N
ауыстыру	V
беттесу	V
еркесі	N
изен	N
аяушылық	N
сүлік	N
күйкі	A
Шыңғысхан	N
орнату	V
немерелес	A
ар-ождан	N
жанар	N
өлең	N
қайраңдау	V
замандас	N
бұйрат	N
абзац	N
дүмпілдеу	V
палуан	N
аспазшы	N
хирургиялық	A
уақытылы	ADV
жүлделі	N
түссіз	A
жаңғыртушы	N
кекеш	N
толқыту	V
қабылан	N
менменсу	V
жайнаңдау	V
жайылу	V
ағатай	N
жолаушылау	V
алтын	N
құрттай	A
тізгін	N
алтын	A
әңгүдік	A
селкілдеу	V
адуынды	A
ықылас	N
қызметкер	N
орта	N
орта	A
итжеккен	N
өздік	A
парасат	N
жаршы	N
доңғалақ	A
недәуір	ADV
аршу	V
доңғалақ	N
шадыр	A
басшылығымен	ADV
шабу	V
лебіз	N
тұйық	A
тұйық	N
қанталау	V
ақтау	V
сендіре	ADV
келген	V
оқу	V
штат	N
сарбаз	N
қаңғыбас	N
оқу	N
келген	A
пайғамбар	N
гигиена	N
зәуімен	N
орам	N
сасық	A
әрмен	N
милиционер	N
сүрту	V
қызметші	A
сықыр	N
шынжырлы	N
өтпейтін	N
диқан	N
бибі	N
мұражай	N
малшу	V
тақ	A
ұлық	N
староста	N
тақ	N
дөң	A
кекшіл	A
қоспа	N
Қалдыбай	N
дөң	N
тепкі	N
иіскеу	V
теңсіздік	N
батсайы	N
пікір	N
жұмбақтау	V
болбыр	A
құйқа	N
Әзірет	N
шүйде	N
қарауындағы	A
кесе	N
тігіс	N
ауқым	N
буу	V
қотырлану	V
мойнақ	N
ызғырық	N
эволюциялық	A
бүлікші	N
пері	N
әсемдік	N
билік	N
шабушы	N
кеуде	N
жандыру	V
күпілдету	V
ақситу	V
осалдық	N
қиналыс	N
сұлу	A
отын	N
ағат	A
қурау	V
айыр	A
секеңдеу	V
шығарым	N
пулеметші	N
оқулық	N
мұнша	ADV
әмбебап	A
зерттелген	A
өмірбаян	N
қиқы-жиқы	ADV
дуал	N
ангина	N
Бөрібай	N
желіктіру	V
сенгісіз	A
метро	N
лепіру	V
қауіп	N
қолдасу	V
түйдек	N
сандалбай	N
ассимиляция	N
сүйреңдеу	V
зерлеу	V
окулист	N
акция	N
баған	N
сойылдау	V
тыс	N
Копыленко	N
дәм-тұз	N
тәттілеу	V
версия	N
Мұқамет-Жөкі	N
илану	V
ағарғанша	N
поэзия	N
түзеу	V
фабрика	N
патология	N
сыпайы	A
сұрғылт	A
изолятор	N
шипажай	N
жинау	V
жүректі	A
археологиялық	A
секунд	N
бөген	N
шығын	N
нарықтық	A
Сауран	N
прима	N
қаңқа	N
керексіз	A
мысық	N
ажарлау	V
пида	N
себебі	CONJ
дәрі	N
аһ	INTJ
біріккен	A
тану	V
қорапша	N
кеңесу	V
торай	N
эфир	N
бармақ	N
Мажар	N
панель	N
роман	N
реформалау	V
ынталылық	N
ыждағат	N
шалшық	N
әуселе	N
кенеулі	A
сабыр	N
сия	N
Қалипа	N
иық	N
қол-аяқ	N
жиыру	V
текшелеу	V
тарасу	V
әсемдену	V
байып	N
шүйілу	V
теміржолшы	N
бірыңғайлау	V
үшкіл	N
диктор	N
қоректену	V
анализдік	A
келесіде	ADV
олқылық	N
басшы	N
қарастыру	V
желбеңдеу	V
жалақтау	V
мейірім	N
бойжеткен	N
шатыр	A
шойнақ	A
сыншы	N
өкілдік	A
бейімдеу	V
ұйықтау	V
құр	INTJ
опа	N
қиысу	V
жазықсыз	A
таңбалы	A
Ахмет	N
одақ	N
пішу	V
заңдасу	V
фуфайка	N
сыбаға	N
түйе	N
кесік	N
жабайы	A
сиреу	V
Мұса	N
саптау	V
естірту	V
иә	N
ұры-қары	N
ордаңдау	V
капитализм	N
нүктелі	A
невропатология	N
төменгі	A
өгіз	N
алақ-жұлақ	N
қоятын	N
қиқарлық	N
бөкебай	N
тегершік	N
аудару	V
қақбас	N
демография	N
акробат	N
Нигер-Сұлтан-Бегім	N
жөнеу	V
жаңбырлы	A
құдаласу	V
ұрпақ	N
борасын	N
қайталау	V
тегістеу	V
ойын-сауық	N
талпақ	A
пышақ	N
концерт	N
риторика	N
Iлияс	N
көргенсіз	A
хор	N
сабалақтау	V
өткеру	V
би	A
бұлаңдау	V
дуылдау	V
тоқмейіл	A
шылану	V
қақтығысу	V
медикамент	N
қорлау	V
қарлұқ	N
миф	N
сарын	N
шықырлау	V
математик	N
иттіс	N
көжек	N
жолбарыс	N
сәурік	N
шемен	N
шахмат	N
балдыз	N
жігерсіз	A
ірің	N
ақбақай	N
ақбас	A
тіреуіш	N
тентіреу	V
қылау	N
быжынау	V
зерігу	V
күл	A
қонбау	V
еріктілік	N
күңгірттену	V
ізгі	A
ару	N
арандату	V
айуан	N
Сығанақ	N
ніл	N
сонымен	PARENTH
адыраңдасу	V
құрама	A
практика	N
мінажат	N
расталу	V
типтік	A
безгек	N
шоқтау	V
Тілеміс	N
жиылу	V
жаралу	V
жөнінде	N
қисса	N
күңкіл	N
ренжіген	A
туыстасу	V
айдала	N
дегенмен	CONJ
жарнамалау	V
әуестену	V
сүрткілеу	V
дирекция	N
балапан	A
норма	N
даулы	A
пәс	A
талғам	N
қисындастыру	V
айшықтау	V
өлше	N
сілтеме	N
үйір	N
Досжанова	N
скептик	N
тарлық	N
қолөнерші	N
пе	PART
ақтабан	N
жамалу	V
жанталас	N
дүние	N
құяң	N
оталу	V
олқы	A
жұбаныш	N
құрбылас	N
зиялылар	N
апандай	A
Несібелі	N
жалдама	A
күнбе-күн	N
терроршы	N
қымтау	V
зырлау	V
әрі-сәрі	A
омыртқа	N
күркелеу	V
асу	N
сіміру	V
жүргізу	V
мінбе	N
арттағы	A
тежеу	V
ай	INTJ
менсінбеу	V
құбылмалы	A
Жолымбет	N
іргелі	A
әзірге	ADV
өштесу	V
Сибан	N
әдетінше	ADV
асу	V
Жұбанов	N
сөйлесетін	A
өзгергендік	N
айла-шарғы	N
қарулану	V
отаршылық	N
үзеңгілес	N
мешел	N
әлсізденген	A
қойнау	N
сырласу	V
ысырап	N
нашақорлық	N
үзік	A
көмескілену	V
Әбілмансұр	N
жанартау	N
әрлеуші	N
арайлы	A
арқа	N
апталық	A
сызат	N
онан	PRO
ағартушылық	N
тамыр-таныс	N
түйреу	V
миллиард	N
қасу	V
жарна	N
солтүстік	N
сыбыс	N
солтүстік	A
Жасарал	N
шаманизм	N
жемдеу	V
емізулі	N
алқыну	V
тазалау	V
сүйек	N
баскесер	N
телебағдарлама	N
ерте	ADV
Қабдолов	N
сылап-сипау	V
сапар	N
жалқы	A
заң	N
кешен	N
бөлетін	A
бірінші	NUM
жарғақ	N
рақым	N
серіппе	N
көтерме	N
ешуақытта	PRO
жығылу	V
жаназа	N
науқастану	V
былайша	ADV
қажырлылық	N
текст	N
құштарлану	V
әуелеу	V
болашақ	N
араз	N
қыздыру	V
пүліш	A
қылтамақ	N
Ысмайыл	N
маза	N
түсінік	N
адам	N
шап	N
суғару	V
тәрбиелі	A
тұтастық	N
білекті	A
шеберлік	N
әлдене	PRO
берік	A
ырзалық	N
әрекет	N
жұмсату	V
кезең	N
бөлеу	V
жеңіл-желпі	N
дұрыс	A
дарыту	V
тазару	V
каникул	N
шабыт	N
булау	V
номинация	N
саудагер	N
кінәлы	A
шытынау	V
былғары	A
уәде	N
сәулеткер	N
солқылдау	V
қажетсіну	V
мотоцикл	N
иран	N
шайы	N
жылтыр	A
арақ	N
галерея	N
қысқарылу	N
бүкпе	N
қада	N
таңу	V
шақпақ	N
келісу	V
даңғой	A
ыссы	A
шиқылдау	V
зерек	A
сауықшыл	N
бурыл	A
навигация	N
аттестация	N
таңдау	V
облигация	N
шаршамай	ADV
тұйғын	N
жеке	A
гепатит	N
құрыштай	A
солай	PRO
аталас	N
мыстан	N
сүңгу	V
шот	N
терең	A
төмендету	V
қоғамшыл	N
астарлау	V
тауысу	V
тамыр-таныстық	N
белағаш	N
иесіздік	N
шүбәлану	V
тікшіл	A
қателесу	V
арлы	A
көктеу	V
баласыну	V
ынтызар	N
ұғыну	V
барқылдақ	N
дариядай	A
жықпыл	N
жыту	V
тентектік	N
табалдырық	N
сәйкесу	V
шуыл	N
жамағат	N
қай-қайдағы	N
қыңсыл	N
қапыда	ADV
жария	N
үнем	N
жетесіз	A
қатыстылық	N
шеге	N
талапайлау	V
реформатор	N
Халима	N
коробка	N
чемпион	N
тоғайлы	A
алдиярлау	V
атқару	V
объективтік	A
ұрттау	V
еңкею	V
шыжу	V
азайған	A
генерал-губернатор	N
ағалы-қарындасты	N
фарфор	N
жылжымалы	A
көшу	V
өтелген	A
қору	V
сөйлем	N
кілемше	N
емдік	A
дырду	A
көздеген	A
балдыр	N
әдет	N
Дүрия	N
бұрыннан	ADV
бие	N
үйіту	V
айқайласу	V
жалмаңдау	V
субъективтік	A
қаныпезерлік	N
ендігі	ADV
орысшалау	V
магистратура	N
жалғаулық	N
көктей	A
үйелеу	V
лотерея	N
рецепт	N
жүйелеу	V
жыл	N
ақылдылық	N
қияқ	N
сыбырлау	V
алдыру	V
Тарлан	N
жалпақтау	V
санаторий	A
дәнекер	A
дұшпандық	N
көтеріліс	N
Шәкәрім	N
жұмыр	A
тесірею	V
беріс	N
шырақ	N
толықсу	V
генерал-лейтенант	N
қасық	N
мұрагерлік	N
керісінше	N
шығарма	N
оркестр	N
сары	A
глицерин	N
шоқтық	N
қатар	N
ілім	N
аншлаг	N
мораторий	N
таптыру	V
нәжіс	N
сырқырау	V
себеп	N
аэропорт	N
рабат	N
қызметтес	N
тайталас	N
ұзару	V
алдақашан	ADV
уық	N
бір	NUM
құрушы	N
тебірену	V
туралы	CONJ
метафора	N
Артықбай	N
Ұлпан	N
артикуляция	N
қой	N
дерт	N
тапқыш	N
қараптан-қарап	ADV
азап	N
ойындағыдай	ADV
бойы	N
шаттық	N
борсық	N
Алматы	N
дегбір	N
мүшелік	N
жетісу	V
көтеріңкіреу	V
жабағы	N
қаулы	N
сенімсіздік	N
тегеш	N
бу	N
селдіреу	V
қосу	V
қазірше	N
өңгеру	V
аялдау	V
унтер-офицер	N
бытырау	V
интенсивті	A
тақуа	A
сергітетін	A
шату	V
өрнек	N
қозғалмайтын	A
жөргек	N
сағым	N
дәрмен	N
түйілу	N
ашқарақтық	N
ләббай	V
тыңдаушы	N
мыңдық	NUM
түйілу	V
жымыру	V
шытырлақ	A
әлбетте	ADV
соңынан	ADV
ғылыми-зерттеу	A
қамыр	N
дюйм	N
күндеу	V
еркі	N
Әбді-Мумин	N
шытыну	V
тынышсыздық	N
қайрылыс	N
алдау	V
сын	N
аян	A
жаздай	ADV
Қаңлы	N
марқа	N
сотталу	V
Қызылорда	N
кесе-көлденең	A
ономастика	N
ине	N
әу	INTJ
бұғаулау	V
өзімсіну	V
синхрондық	A
дәрісхана	N
бөлмелі	A
бүрісу	V
лақа	N
борт	N
қиғаш	A
үтік	N
жойқын	A
сына	N
жазғыру	V
ізсіз	ADV
үлгі-өнеге	N
мекен	N
бозару	V
шөп-шөп	INTJ
Әбдірашит	N
қурай	N
шұбалаңдау	V
қоздырғыш	N
тұман	N
кепілдеме	N
тұмау	N
тақылдақ	N
балдақ	N
жамандау	V
үзбестен	ADV
қарғану	V
қасапхана	N
термин	N
стратегия	N
Yргеніш	N
бақылану	V
каторга	N
қоңсы	N
сонда	PRO
ә	INTJ
репетиция	N
арандатушылық	N
кештеу	ADV
әкімшілік	A
қылшық	N
әкімшілік	N
өрмек	N
қарып	N
әсерлі	A
қауырсын	N
балалау	V
ынта	N
ығы-жығы	N
де	CONJ
жалғасу	V
тоңу	V
бағынбау	N
мұрын	N
электр	A
табандау	V
жарлы	A
бүлікшіл	N
дипломат	N
бәсеке	N
кеңейту	V
піл	N
Мұхтар	N
көлшік	N
кейде	ADV
үтір	N
баспахана	N
дайындау	V
есеп	N
еркін	A
бағыныш	N
бөтендік	N
зымиян	N
жариялау	V
әзіз	A
жіп	N
таспалау	V
па	PART
төңкеріс	N
поезд	N
серке	N
линотип	N
керту	V
реферат	N
алаңқай	N
шартылдау	V
шық	N
спорт	N
ұйықта	V
жоспарлану	V
араздастыру	V
төзім	N
тықыл	N
шофер	N
арандатушы	N
дәліз	N
жып-жинақы	A
жібек	A
күлдіретін	A
танысу	V
жыламсырау	V
тағам	N
күнбатыс	N
жапырақ	N
онкүндік	N
тәуелділік	N
жұрағат	N
ойналу	V
соғушы	N
ымдау	V
сұрапыл	A
регистр	N
мұқтаж	N
сыйыну	V
қайнататын	N
Исан-Бұғы	N
пьеса	N
Анна	N
кертартпа	A
кереует	N
резервист	N
дүйім	PRO
мазмұндау	V
иір	A
жуырда	ADV
жарқыным	INTJ
күлше	N
неврология	N
қараңғылық	N
ақылгөй	A
қысылыс	N
қақалу	V
қоғамдық	A
өліп-талып	ADV
шумақ	N
құлаш	N
қорыққан	A
қайынаға	N
бюллетень	N
ырбаңдау	V
талғампаз	A
қырман	N
түбек	N
мұқтаждық	N
бедірею	V
әже	N
қадым	A
материя	N
қаскөй	N
интонация	N
майонез	N
түсіру	V
жік	N
хабар	N
ескі-құсқы	N
әшейін	ADV
ән	N
күл-талқан	N
жалықтыру	V
құрақ	N
марқабат	N
сатыр-сұтыр	IW
күзетші	N
сүйріктеу	V
босау	V
бөгет	N
жарыстыру	V
тұрмыс-салт	N
төменде	ADV
пролетариат	N
қортынды	N
ертеде	ADV
кең-байтақ	A
долы	A
антұрған	A
жиі-жиі	ADV
лықиту	V
тәрелке	N
үсті-үстіне	ADV
салдық	N
бүк	N
күрмеу	V
құрсағындағы	A
наза	N
селитра	N
қадір	N
қолдану	V
қосетек	N
бастау	N
итіну	V
саңлақ	A
департамент	N
кеңшілік	N
сортты	N
қомдау	V
бастау	V
ғибрат	N
жібу	V
созылмалы	A
құлыптаулы	A
опыру	V
қомағай	A
сессия	N
мәулет	N
ашулану	V
керенау	A
ұсқынсыз	A
бұжырлау	V
бете	N
сүйінші	N
жанұя	N
әдіптеу	V
бутерброд	N
сезік	N
сарбас	N
жұрдай	A
шешек	N
Ресей	N
қытықшыл	A
алғыш	A
мәлімдеу	V
сәуегейлік	N
рәсім	N
сауым	N
Өзбекстан	N
жаздыгүні	ADV
талдыру	V
аяз	N
дөп	N
арзу	V
сом	N
балшық	N
оңға	ADV
қашау	V
менсінбей	ADV
ілу	V
төбелесу	V
рота	N
түнгі	A
тым-тырыс	A
қыркүйек	N
қашан	PRO
бағанағыдай	A
арыстай	A
жаңару	V
цирк	N
депозит	N
айдай	A
сұм	A
түсіндіру	N
Гәуһар	N
губернатор	N
логика	N
аргумент	N
династия	N
мертіккен	A
сылдырау	V
тесе	N
сарқырама	N
Нұрпейісов	N
Сүлеймен	N
тіркемелі	A
түсіндіру	V
функция	N
оңайлық	N
қайырлы	A
фельетон	N
ажарлы	A
тымыраю	V
көнетоз	A
басшылық	N
апырып-жапыру	V
сүргін	N
жоспарлау	V
сабақтау	V
сопы	N
жетістік	N
кішіпейілділік	N
пісті	N
бақылау	V
мінездеме	N
ашу	V
батыс	N
зулау	V
жарапазан	N
Сызғанов	N
танау	N
сөзбе-сөз	ADV
килограмм	N
бөгу	V
белгілеу	V
шімірікпей	ADV
ирек	A
қарақалпақ	N
тістеуік	N
қортындылау	V
үрлеу	V
жемірілу	V
Юрий	N
жүзік	N
өстіп	ADV
қозғау	V
меніңше	PARENTH
тиеу	N
мыңқылдау	V
қайнату	V
қоға	N
ақпар	N
қозғалмай	ADV
тұлпар	A
Еламан	N
арқар	N
кебеді	V
азық-түлік	N
қарану	V
ротация	N
дамылдау	V
африка	N
кәдік	A
гүрілдеу	V
түптеу	V
ойнақшу	V
қарынша	N
оншама	ADV
соғұрлым	ADV
тарих	N
тоқ	A
алапес	N
тұяқты	N
ревматизм	N
мұрындық	N
ақшабақ	N
аңыз-әңгіме	N
ұлғайтылған	A
жүйрік	A
ғұлама	N
өлексе	N
тою	V
дөнежін	N
сардала	N
кеспелтек	A
лақат	N
қайғы-қасіретті	A
бекем	A
дәмету	V
мүдіру	V
критерий	N
семасиология	N
құсалы	A
кіші	A
қызғану	V
атыс	N
айрықша	A
емделуші	A
доллар	N
аянбай	ADV
өлермен	A
дүйсенбі	N
шақыратын	A
ағарту	V
сөндіргіш	N
монах	N
әшекейлі	A
сексен	NUM
шонжар	A
салдырау	V
ротмистр	N
таю	V
шикізат	N
құрылтай	N
жұмсар	V
айлакерлік	N
бейберекет	A
үру	V
квартет	N
қамқа	N
цистерна	N
қанағаттану	V
ғұмыр	N
күзгі	A
науша	A
отырықшылық	N
алшақ	A
әмірлік	N
нақтылау	N
сырмақ	N
ұйымдасу	V
құнттап	ADV
артист	N
бақыт	N
жапсарлас	A
планета	N
тықпалау	V
Қарашеке	N
ей	INTJ
демократиялық	A
шам	N
шөгеру	V
сағыныш	N
қобыз	N
аптау	V
жылу	V
кекесін	A
бассыздық	N
бесжылдық	A
шұлғау	N
тығырық	N
оқтау	V
шідерлеу	V
аудан	N
басты-басты	A
абат	A
ызыл	N
тайпа	N
ауған	N
жорғалау	V
таңғалу	V
қары	N
шөке	N
шетінеу	V
тізбе	N
іздеуші	N
валюта	N
жортақ	N
тірі	A
елік	N
сорайған	A
көген	N
үйлену	V
әзаға	N
референдум	N
көрсетілу	V
мандарин	N
кітап	N
екілену	V
тағалау	V
насихатшы	N
агрегат	N
фамилия	N
валентті	A
солқылдақ	A
тұқы	N
қожыр	A
иткендір	N
орасан	ADV
иемдену	V
игер	N
еркінсу	V
шолпан	N
жұт	N
жайғасу	V
Бәкизат	N
ермек	N
қарға	N
ертеңіне	ADV
қалмақ	N
көрешек	N
керенаулық	N
комендант	N
арсенал	N
сәттілік	N
Мауреннахр	N
атқарушы	A
атқарушы	N
аламандық	N
пасық	A
жеті	NUM
шана	N
зар	N
найсап	A
таяуда	ADV
ұялшақтық	N
әңгімелеу	V
тыңаю	V
құлық	N
ақы	N
хал-ахуал	N
торыққан	A
туу	V
алуан	A
жайылым	N
помидор	N
алтындау	V
ұлыс	N
мемориал	N
көпшілік	N
саратан	N
қорлық	N
сүймен	N
қозғалақтау	V
мәдениеттілік	N
жетіген	N
аттылы	A
Қарақожа	N
асыру	V
функционализм	N
танк	N
шарпу	V
қампию	V
ғылыми-техникалық	A
атбегі	N
өксік	N
перизат	N
бис	N
пәруардігер	A
мүгедек	A
үрпиту	V
байбалам	N
акушерлік	N
Бикен	N
шошақай	A
Берке	N
ағаттық	N
күз	N
ұшталу	V
тарихи	A
топонимика	N
қызықшыл	A
жыртқыш	A
оңды	A
биіктеу	V
әңгілену	V
осу	V
асырау	V
шешендік	N
жұбану	V
қадірлеу	V
опыр-топыр	N
аздыру	V
мамыр	N
қаскүнем	N
жылымшы	A
күйдіргі	A
жазбаша	A
дүмбіл	A
аттаныс	N
тойындыру	V
ақырет	N
фонетикалық	A
ойпат	N
квота	N
Омаров	N
группа	N
сұраншақ	N
табақ	N
айтуынша	N
күзек	N
құбыр	N
жаулық	N
ілулі	A
шаппа	N
жайдақ	N
дүниежүзі	N
баурай	N
шоғырлану	V
Жәке	N
пейзаж	N
томаға-тұйық	A
мұқаба	N
жетіспеушілік	N
төлету	V
ұмытпау	V
сабырлық	N
даналық	N
оралым	N
әл-дәрмен	N
сорпа	N
тамамдау	V
ашулы	A
қадақтау	V
кей	PRO
ұйқылы-ояу	A
нақтылы	A
Европа	N
әйтседе	ADV
төлем	N
тату	V
күрделі	A
бейімделу	V
реформа	N
сауығу	V
кебін	N
ұн	N
Әл-фараби	N
көз	N
экскурсия	N
қал	N
қаңсу	V
өз	PRO
өкілеттілік	N
жұмсау	V
адмирал	N
Абылай	N
Сәмеке	N
еш	PRO
ауыр	A
нар	N
Гүлбаршын	N
сүймендеу	V
сорақы	A
кезекшілік	N
пысықтау	V
айқай	N
ораулы	A
шаң	N
мелшиген	A
енжарлық	N
салдақы	N
жарғы	N
консерватория	N
мейір	N
социалистік	A
Кенен	N
сабалақ	A
тойғаныңша	ADV
далба-дұлба	A
екпіндеп	ADV
салт-сана	N
лаң	N
Батеш	N
бейне	N
оқтын-оқтын	ADV
тасбауыр	N
стол	A
баяндау	V
механизатор	N
аршындату	V
күнсу	V
айғыз-айғыз	A
сықырлау	V
андыз	N
кебіртең	N
мақтаншақ	A
әрбір	PRO
ай	N
себепші	N
ақшыл	A
дәлме-дәл	A
Шидей	N
ибалық	N
шыдам	N
шомбалдау	V
лифт	N
рулас	N
қашар	N
сарнап	ADV
жұмыртқалату	V
Есенов	N
қане	INTJ
ығыр	N
ызу	V
бешпет	N
сілікпе	N
парақор	N
әдемілік	N
сарап	N
алару	V
ожарлану	V
оймақ	N
жасырынбақ	N
автомат	N
наздану	V
тасыр	N
педагогикалық	A
мейірбан	A
бұғана	N
аванс	N
жиде	N
меценат	N
жырақта	ADV
сойыл	N
Мұқанов	N
ойбайлау	V
өзгелік	N
анкеталық	A
кедергі	N
былық	N
алақайлау	V
тур	N
әшекей	N
тақау	V
жүгері	N
тең	A
дүрліктіру	V
экспанция	N
айдындай	N
кез	N
тең	N
тұрпат	N
қақтау	V
сабақ	N
бәсең	A
бөгде	A
жарушы	N
қармау	V
шөл	N
бастығу	V
бақталастық	N
хабардарлық	N
микрофон	N
жолау	V
Әлия	N
бүгу	V
серуен	N
сыңғырлау	V
шейін	CONJ
арқан	N
қияли	N
жалпы	A
жыныс	N
айдалу	V
қазу	V
сипат	N
бойынша	ADV
Тарази	N
феодализм	N
ықпал	N
бесеу	NUM
тыйылу	V
дөңбек	N
әкіреңдеу	V
шарылдау	V
ағалық	N
кебенек	N
филология	N
күш	N
көктерек	N
асылы	N
хикая	N
ратификациялау	V
қарауыту	V
беті-қолы	N
кафедра	N
созу	V
қарайласу	V
елгезек	A
тілек	N
сырттай	ADV
ұрандасу	V
ба	PART
сығым	N
логарифм	N
құлақ	N
күздігүні	ADV
тігулі	A
акустика	N
қайсарлық	N
жаратылыс	N
мұрша	N
кубок	N
маймаңдау	V
аяқталу	V
талон	N
сүзу	V
шатқал	N
ықтияр	N
шайқы	N
жамағайын	N
сөйлемеу	V
ақпарат	N
қоңыраулату	V
басыну	V
бюст	N
жапыраю	V
Әбусейіт	N
тыңайтқыш	N
симпозиум	N
фото	N
тікенек	N
шырылдау	V
қасқабас	N
емдеуші	A
иісті	A
аңқаусу	V
телеграф	N
күнәлі	A
сірә	ADV
кері	A
жорту	V
тырбаңдау	V
дәмелену	V
дәмдеу	V
агротехникалық	A
шашу	V
уыз	N
қалықтау	V
салғырт	A
сантиметр	N
сұғу	V
айыпталушы	A
тауыс	N
көлеңкелі	A
елтірі	N
Гүлнар	N
тұқыру	V
алыпсатарлық	N
жүлдегер	N
ұялу	V
қаптау	V
құқы	N
мықтау	V
кәкір-шүкір	N
бейбақ	A
осылай	ADV
сатпақ	A
егіс	N
көшірме	N
жалғыздық	N
Тәкен	N
терлік	N
орнығу	V
сақтау	V
онша	ADV
жебе	N
тұқымдас	A
қауіптілік	N
бойдақ	N
қаһарлы	A
алапестей	A
кілегейлену	V
бақташы	N
Төлеубек	N
комплекс	N
тұжырым	N
саяхатшы	N
мажыра	N
банка	N
қазбалау	V
саяси	A
талас	A
малшы	N
рәсуалау	V
аймақтық	A
арып-ашу	V
қарт	A
сумаңдау	V
сейсенбі	N
аралас	A
түлеу	V
Жейхун	N
балпаңдау	V
бірер	PRO
ажарлану	V
отан	N
қиянаттау	V
зергерлік	N
ауқатты	A
ғажайып	A
анда	PRO
үрпек	A
бөліктеу	V
Ғайша	N
ақселеу	N
лексикография	N
кабина	N
соғу	V
бұралқы	A
қайшыласу	V
тамызық	N
жаратпау	V
ақыраю	V
аттас	A
бірдеме	PRO
айналайын	A
эмоция	N
таласу	V
сұлы	N
ертеректе	ADV
күйдіру	V
эмблема	N
сәулетші	N
қыр	N
сықылды	A
урбанизация	N
аспай-саспай	ADV
жұқпалы	A
пысылдау	V
жауынгерлік	N
бүйірлі	A
суыту	V
түлеу	N
дауыл	N
будка	N
жұмысшылар	N
бөлме	N
соқырлық	N
жоғалу	V
меңгеруші	N
арбау	V
ұзындық	N
рахмет	N
бұрылыс	N
дағды	N
емізік	N
тарақ	N
Ғаббас	N
құшу	V
Ыдырысов	N
монша	A
кірпік	A
дырылдау	V
ниеттену	V
қабылдау	V
қаймана	N
тұрақты	A
ену	V
мақта	N
атылу	V
сүйреме	N
құтылу	V
алыпсатар	N
етікші	N
жең	N
ұлтан	N
ашу-ыза	N
балалық	N
ғазиз	A
сасқалақтау	V
жау	N
жүздеу	V
шолғыншы	N
жетіскендік	N
жаңғақ	N
браконьер	N
қағысу	V
шиқылдақ	N
малқора	N
ықтырма	N
жайлап	ADV
өткендегі	A
селсоқ	A
мүдде	N
империя	N
маркетинг	N
заңгер	N
қаз-қатар	N
бояну	V
аман	A
тіксіну	V
дәйектеме	N
бұ	PRO
артынша	ADV
иман	N
бітеудей	ADV
жеңілдеу	V
толғану	N
надандық	N
көл-көсір	A
шүрегей	N
футболшы	N
сайлау	V
тіресу	V
ділгер	A
жолақы	N
баба	N
сода	N
Жаркент	N
сірке	N
ұзын	A
қапияда	ADV
кедейлік	N
аккордеон	N
тосқауыл	A
сулау	V
иістену	V
жалығу	V
поэтика	N
тәттілік	N
террор	N
қарапайымдылық	N
Израиль	N
артық-кем	N
қырылдақ	A
Керей	N
тамаша	A
көрінуі	N
лаулау	V
саябақ	N
Бахар	N
жарымжан	A
кіріспе	N
пісу	V
ояу	A
Алтай	N
тайғанақтау	V
бөгесін	N
төркіндеу	V
тұжырымдау	V
жеңілтек	A
жүдету	V
отыншы	N
жегі	N
Жиренше	N
бағаналы	A
сыю	V
боялу	V
қалпақ	N
бажыраю	V
жаттанды	A
осындай	A
белок	N
өкімет	N
қызығу	V
қайыршылық	N
басталған	A
муниципалитет	N
қорыл	N
ойлану	V
иммунитет	N
өн	N
сұлтан	N
аударыстыру	V
шырайлы	A
жанармай	N
құрал	N
қуғыншы	N
артель	N
алыну	V
күйсеу	N
ұяңдық	N
Бахтияр	N
кемде-кем	ADV
бітім	N
көмекей	N
жеткіліксіздік	N
сөну	V
қабару	V
салиқалы	A
ауыл	N
актив	N
қағыту	V
алакеуімнен	ADV
алыс	A
жарақат	N
борыш	N
албырттық	N
соқа	N
жауапсыздық	N
тұншығу	V
институт	N
Ескендір	N
ділмар	A
ветеринар	N
қайтпас	A
ықтимал	A
қалау	V
статистика	N
минарет	N
итошаған	N
еншілес	N
әкелу	V
апайтөс	A
құрылым	N
мектеп-интернат	N
өтпес	N
іріңдеу	V
замат	N
ары	N
тамыршы	N
шомылу	V
зақымдау	V
қайдағы	N
сүре	N
білмеу	N
ендік	N
қырындау	V
зырқырау	V
перделеу	V
түркия	N
кебеже	N
өшкен	A
сыйғызу	V
субсидия	N
қуанарлық	A
дабыл	N
дуа	N
жүздесу	V
жаралы	A
самғау	V
сабан	N
Елебаев	N
ертедегі	A
көлік	N
тал	A
разылық	N
құмарлану	V
анадай	PRO
тал	N
ессіздік	N
бау-бақша	N
ендігәрі	ADV
абысын	N
шұқу	V
оңайлану	V
сыйымдылық	N
әуесқой	A
десте	N
қосынды	N
қалдық	N
шаңғыту	V
шытырлау	V
шабыншылық	N
берірек	ADV
айлы	A
негіздеме	N
кішірейген	A
мәлімет	N
қасару	V
табын	N
драма	N
сақау	A
кәріз	N
дефис	N
сарқу	V
бұзақы	N
ме	PART
жан-жақ	N
сеніңше	PARENTH
латын	A
танымал	A
арнау	V
мүлдем	ADV
олжа	N
ұсыным	N
алайда	ADV
тәжірибелі	A
керілу	V
отбасы	N
айдаһар	N
формат	N
нобай	N
тыныс	N
болғанша	ADV
бөріктіру	V
мундир	N
реставрациялық	A
Есеней	N
актілеу	V
алаңғасар	A
ытқу	V
көркемөнер	N
жөнсіздік	N
қалқан	N
бөкен	N
исіну	V
антихрист	N
бұзушы	N
туысқан	N
иісшіл	A
коммунист	N
көксерке	N
символдық	A
қаздаңдау	V
өкініш	N
сілтеу	V
бұзылу	V
жауапкершілік	N
реакция	N
екіқабат	A
татым	N
әйгілі	A
тынығу	V
үкі	N
айналу	V
аузы-аузына	ADV
жасару	V
шанаш	N
үймелеу	V
теріскей	N
хатшы	N
толы	A
партиялық	N
түгесу	V
ол	PRO
осыншалық	N
кәнігі	A
күнәлау	V
жаңалау	V
қайырым	N
тектілік	N
реестр	N
серпіліс	N
қызу	V
тоқыту	V
домалату	V
ысыру	V
қазан	N
сандырақ	N
ұшқындау	V
аяқжол	N
архитектор	N
қырылу	V
құман	N
топтасу	V
морфема	N
көтеру	V
құзғын	N
муфти	N
демалу	V
шайнау	V
ағындау	V
нышан	N
дүрс	N
лапылдау	V
әп-әдемі	A
бұршақ	N
марал	N
әманда	ADV
ғанибет	N
шындау	V
латынша	ADV
герцогиня	N
дерек	N
күкірт	N
қыңқыл	N
стадион	N
атазаң	N
ұнатқан	A
ғашық	N
жарадар	A
дау-шар	N
ғашық	A
жобалау	V
қылғындыру	V
арбакеш	N
мұра	N
Иса	N
баспақ	N
беріш	N
өскелең	A
лағу	V
Қажыбек	N
үндеу	V
аңғырттық	N
дастан	N
гарнизон	N
сора	N
тайыз	A
дара	A
дәлдеу	V
дұрысында	ADV
құп	INTJ
күштеу	V
Шиелі	N
жастану	V
сәлемдеме	N
бақандау	V
төңіректеу	V
мақсат	N
өткен	A
бойлау	V
постулат	N
арамдау	V
ие	N
тонау	V
қалыптасқан	A
шер	N
пакет	N
күмән	N
күмән	A
қала	N
бақша	N
рояль	N
есіркеу	V
қандай	PRO
жабдықталған	A
қорытынды	N
жанғыш	A
салыстырмалы	A
батальон	N
қойшы	N
әйелдік	A
қысық	A
қараңғылау	V
күндестік	N
ханша	N
сіңірлі	A
қоршау	V
дамушы	A
тұқымдық	A
салбыр	A
жүдеулік	N
тұл	N
тайғанау	V
мәдениет	N
қораб	N
күлімсіреп	ADV
тұл	A
Әбікен	N
бадам	N
тасалану	V
тамыз	N
айыпталу	V
азат	A
иландыру	V
фольклоршы	N
кірісу	V
дәйек	N
сарғыш	A
ренжімейтін	A
рақаттану	V
ылдилау	V
осал	A
аптығу	V
толқымалы	A
білгірлік	N
алла	N
мүлде	ADV
комитет	N
Қаныбек	N
кәсіпқор	N
тездік	N
академиялық	A
бөлтірік	N
Құмарова	N
жұмарлану	V
қатыссыз	ADV
өмірлік	A
жер-ана	N
қазоты	N
қастандық	N
баяғы	A
рецензия	N
малай	A
жеркену	V
маңай	N
кемшілігі	N
жиегі	N
білінбеу	V
резолюция	N
запас	N
бөлек	A
мертігу	V
шекісу	V
тығыздық	N
кезбе	N
әзір	A
үйренуші	A
жиналыс	N
пікірлес	N
табақтай	A
ала	N
айғыздау	V
ала	A
есек	N
еріншек	A
істелген	A
ұғу	V
алаламай	N
бағзы	A
қысқару	V
көмек	N
бе	PART
үйлі	A
такси	N
авиабаза	N
жалақ	N
монолит	N
үрпе-түрпе	A
пұл	N
жаратушы	N
қаңтар	N
медресе	N
өзекті	A
лаж	N
бейтараптандыру	V
одыраю	V
бөлекше	A
жылтырақ	A
түсте	ADV
безеру	V
сауат	N
армандау	V
эксперт	N
бола	CONJ
қайтар	N
футбол	N
ертелік	A
мансапқорлық	N
сүзбе	N
таблетка	N
шарықтап	ADV
император	N
өтіну	V
қомыт	N
абсолюттік	A
жапыру	V
ауыру	V
содыр	N
қаз	N
ұқтыру	V
мәлімсіз	A
ақыреттік	A
келе	N
доза	N
қырық	NUM
дәріптеу	V
шұқшию	V
үзу	V
күлімдеу	V
сұқтану	V
кет	V
арыту	V
білдірмей	ADV
емле	N
іс	N
тың	A
тамашалау	V
тарау	V
тарау	N
авиация	N
шықылықтау	V
аюдай	A
икемдеу	V
алғанша	ADV
тырнақ	N
түрлі-түрлі	A
айлакер	A
жасықтық	N
шәлкес	A
өлмес	A
барабан	N
армян	N
төсек	N
алға	ADV
іңкәр	N
актер	N
шимайлап	ADV
Сарыбай	N
оператор	N
Елизавета	N
алтыатар	N
асығыстық	N
көгендеу	V
әріптес	N
жалын	N
мансапқор	N
аспалы	A
команда	N
қиқым	N
жылма-жыл	N
жыршы	N
қызғана	ADV
сәлде	N
жауығу	V
сайлаушы	N
афиша	N
артық	A
жақтырмау	V
жауу	V
скрипка	N
спикер	N
құрылыс	N
өлім	N
мекеме	N
болу	V
қоқу	V
жеңгізу	V
механик	N
икемділік	N
өрмелеу	V
томпаңдау	V
алып-ұшып	ADV
деканат	N
бұрыш	N
аллалау	V
өтем	N
сотқарлық	N
оңдау	V
шыншыл	A
Рабиу-Сұлтан-Бегім	N
көрнекілік	N
омбы	N
шалғай	A
тілеу	V
компания	N
сыбырлап	ADV
күлгін	A
тиянақты	A
кебу	V
ынтымақтасу	V
ерекшелік	N
іркіт	N
жерсіну	V
пленум	N
шүйіру	V
тоқсаныншы	A
бұрынғыша	ADV
жүйелі	A
артықша	A
жә	INTJ
көң	N
алдымда	ADV
жылт-жылт	ADV
сынық	A
атақоныс	N
бұнда	ADV
сүр	A
аспау	V
монастырь	N
жыю	V
жарау	V
қойылған	A
ақсақтық	N
ың-жың	N
Атамбаев	N
қапа	A
сән-салтанат	N
тарсылдау	V
қаншадан	PRO
күлдіру	V
арту	V
белдесу	V
қажалу	V
шалғайлық	N
беташар	N
өзара	A
жайдары	A
ұмсыну	V
қам-қарекет	N
нотариус	N
ескіше	ADV
Ертіс	N
аудитория	N
емес	PART
тепкішек	N
Барақ	N
шалқақ	N
божу	N
тұлым	N
қапысыз	A
әйелжанды	A
тәтті	A
цех	N
мінез	N
Галина	N
нығыз	A
ақталу	V
ойын-күлкі	N
түю	V
шалқу	V
крахмал	N
анадайда	PRO
ау	INTJ
пәктік	N
ұқыпты	A
айтылу	V
абыз	N
шежірелі	A
мінету	V
өлімсіреу	V
пісіп-жету	V
былғану	V
дуадақ	N
индекс	N
ұйқысыздық	N
тәртіп	N
тұрақсыздық	N
ақтару	V
археология	N
ұшқалақ	A
ырғақ	N
қалааралық	A
атты	N
келешексіз	A
идея	N
қорыту	V
әкімдік	N
оқтану	V
қаймығу	V
бастауыш	N
ревизор	N
шағу	V
ұлан-байтақ	A
қадақ	N
жантаю	V
белді	A
төлемақы	N
апиын	N
ставка	N
жапалақ	N
нәрсе	N
қатын	N
құйысқан	N
демеу	A
сағақ	N
вектор	N
гардероб	N
қат	N
жоғалту	V
дене	N
күркіреу	V
құрықтау	V
жылқышы	N
ресми	A
ондаған	NUM
ұлттық	A
форма	N
кешіктіру	V
найза	N
жыртық	A
жұмысшы	A
газет-журнал	N
биылғыдай	A
әкей	N
кескілесу	N
кескін	N
кәдімгі	A
құнттау	V
құрыш	N
білгіш	N
тым	N
анда-санда	ADV
қағанақ	N
тоқпақтасу	V
Сібір	N
мақтаныш	A
дыңылдау	V
батылдану	V
қауіпті	A
ұңғы	N
коалиция	N
зиянкес	N
мұнарлау	V
көргіш	A
пункт	N
атажұрт	N
дөрекілік	N
құтыру	V
ағару	V
бұздыру	V
бірте-бірте	ADV
жабулы	A
теңдеу	V
Саадат	N
күлу	V
көл	N
келіншек	N
қобу	V
шырмауық	N
қырғи	N
Тұмажан	N
қайтару	V
мәңгі-бақи	ADV
павильон	N
жәрдемдесу	V
жүнді	N
килігу	V
қалтырау	V
адрес	N
нұр	N
араздық	N
шабақтау	V
кіреберіс	N
дулыға	N
орманшы	N
ақпан	N
ата-тек	N
өзгешелену	V
майталман	A
түймелеу	V
велюр	N
жалдау	V
омбылау	V
өлген	A
малу	V
инелік	N
керуен	N
Египет	N
жуан	A
қаржы-несие	A
Қабанбай	N
кеме	N
үзім	N
айында-жылында	N
ойыс	N
бұру	V
біреу-міреу	PRO
көміртек	N
жолдау	V
Yгедей	N
арай	N
құмарту	V
елу	NUM
беймаза	A
етістік	N
жолдау	N
өну	V
салқын	A
сержант	N
өкіру	V
қорғасын	N
көн	N
ликер	N
күндізгі	N
көгеру	V
құрметтеушілік	N
индивидум	N
алдағыш	N
больница	N
тұрпайы	A
сәжде	N
бейжай	A
білмегендік	N
шексіздік	N
телесабақ	N
лақылдау	V
жап-жарық	A
жүрдек	A
төралқа	N
ырсылдау	V
мәйіт	N
мойын	A
қарлығаш	N
талдырмаш	A
беймәлім	A
лидер	N
ескілік	A
Бәтима	N
бөлшектеу	V
қарта	N
Бурабай	N
тепсіну	V
жүкші	N
бүкілодақтық	A
тамшы	N
инабаттылық	N
шыншылдық	N
талықсу	N
бармау	V
елемеген	A
шұбар	A
нашар	A
дәурен	N
дәурен	A
бейтарап	A
басқасыну	V
шуаш	N
қансырау	V
әйткенмен	ADV
қаламгерлік	A
көркемсурет	N
зембіл	N
ирандықтар	N
дау-дамай	N
тербелу	V
азербайжан	N
ғибадат	N
оқтау	N
Шәңгерек	N
мерекелік	A
жалақ-жұлақ	ADV
сүрлем	N
боксшы	N
баяндауыштық	N
сүріну	V
қатты	A
кейіту	V
диплом	N
ерін	N
шыбын	N
шағын	A
тергеу	V
жаңа	A
абырой	N
ақымақшылық	N
қуыстану	V
тулақ	N
тақтайлау	V
тырысу	V
тайлақ	N
жүрексіну	V
қаламұш	N
толарсақ	N
жыбырлату	V
жылым	N
екеу	NUM
Дәнеш	N
тексеруші	A
жуып-шаю	N
әйтпесе	ADV
арбасу	V
асфальт	N
сабалау	V
нюанс	N
інген	N
кәрілік	N
мүлгу	V
ілгеріден	ADV
орналасу	V
елпеңдеу	V
хабарлау	V
кісендеулі	A
Күшікбай	N
режим	N
ине-жіп	N
мысқылшыл	N
әзіл-қалжың	N
кептіретін	A
зеңбірекші	N
пианино	N
апыл-тапыл	ADV
артынан	ADV
таутеке	N
шынжырлау	V
қамсыздандыру	V
шоғыр	N
тағылану	V
конфигурация	N
көкорай	N
шиыршық	N
қолғанат	A
қалпынша	ADV
агенттік	N
сынықшы	N
сақаю	V
дифференциал	N
аттылы-жаяулы	A
қисаңдау	V
кесір	N
әуес	A
көнбейтін	A
даярлық	N
дүкен	N
объективті	A
ұстаным	N
илеу	V
дүрліккен	A
септесу	V
гуманист	N
гүлстан	N
дін	N
ұрғашы	N
баяғыдай	ADV
ырыс	N
байланысу	V
зорлау	V
жөтелу	V
жығу	V
абзал	A
негіздеу	V
өжеттік	N
жын	A
матрица	N
ғашықтық	N
	
айқындау	V
мысқылдау	V
жаралау	V
терлету	V
шылбыр	N
ыза	N
шымшық	N
фанатизм	N
кітаби	A
жазалы	A
роль	N
қыру	V
жаудырау	V
ұйлығу	V
мағлұмат	N
турату	V
қалақай	N
әлдеқашан	ADV
гид	N
керең	A
лексикалық	A
аурухана	N
тығылу	V
арқандалу	V
әлденеше	PRO
құрғау	V
межелеу	V
дарқан	A
жөнді	A
үздіксіз	A
өсекшіл	N
жидек	N
оюлау	V
әлгіндей	ADV
ойнау	V
бедел	N
келімсектер	N
семинар	N
сағанақ	N
Хакім	N
маса	N
толассыз	ADV
білгішсіну	V
күрт	N
сүйел	N
әріден	ADV
пиғыл	N
шайхана	N
көңілсіздік	N
кіруі	N
алқам-салқам	A
қалғыту	V
құдалық	N
қоңылтақ	N
жұлу	V
Әбдісаттар	N
нан	N
далбаса	N
таспа	N
әрлі-берлі	ADV
тектестік	N
шелектеп	ADV
өлшеу	V
ғайыптан	N
ашушаң	A
шүберек	N
эпос	N
тымақ	N
піскен	A
берекелі	A
қызмет	N
некелеу	V
саусақ	N
таңғажайып	A
қақпақ	N
күншілдік	N
дәрет	N
жұлдыру	V
майдангер	N
алаулау	V
жеру	V
тоғын	N
жиен	N
самаурын	N
белдеу	N
аңкылдақ	A
өле-өлгенше	ADV
өліп-өшу	V
ержеткен	A
еліру	V
дара-дара	A
күлді	A
дорба	N
киілу	V
жәдігөй	N
гүмп-гүмп	N
қорық	N
қайрат	N
тоқу	V
балдай	A
арандау	V
лама	N
жабырқаңқы	A
күйлі	A
кек	N
қыдыңдау	V
күпірлік	N
фармацевт	N
үлкендік	N
дағдарыс	N
жайпау	V
жемтік	N
орталық	A
есептелген	A
Ғайни	N
жапалақтау	V
есімдік	N
артығы	N
бажылдақ	N
қоздыру	V
қабыршық	N
бас-аяғы	N
елеуреу	V
серігу	V
үрейлену	V
таз	A
құндыз	N
қиын	A
күң	N
мейіз	N
атой	N
сусау	V
дүрліктірді	V
үйткені	CONJ
ой	N
титықтату	V
көрнекі	A
күреу	V
балағаттау	V
тұрмыстық	N
нәзіктік	N
филиал	N
тек	N
әуел	ADV
ашаршылық	N
азиат	N
қазан-аяқ	N
рельс	N
бөсу	V
сойқандау	V
әзер	ADV
мекендеу	V
уқалау	V
құбыжық	N
ежірею	V
абыр-сабыр	N
таусылу	V
жұтаңдық	N
көшпелі	A
талап	N
кісінеу	V
қантамыр	N
есту	V
автономия	N
жетіжылдық	A
мұсылманшылық	N
Жұмағали	N
азан-қазан	N
сапыру	V
ток	N
қытымыр	A
төмендеді	V
адыраңдау	V
грузин	N
тарам	N
бұлақтай	A
әумесер	A
тынық	A
бертінде	ADV
күдік	N
Қаракерей	N
томпаю	V
еркіндік	N
шығындау	V
жеделхат	N
әжім	N
кофе	N
Ершай	N
сарқырау	V
саба	N
зеңгір	A
Неплюев	N
елуінші	NUM
солдан	ADV
әуендету	V
отаршыл	A
маялау	V
булығу	V
тербеу	V
тымырсық	N
комиссариат	N
Қалиев	N
қырқыншы	NUM
айдар	N
түкситу	V
тықылдату	V
бұрқасын	N
егес	N
өте-мөте	ADV
сербию	V
жоралғы	N
әмірші	N
мешіт	N
мастану	V
пельмен	N
кіжіңдеу	V
жұмыс	N
сүйкім	N
сауаттылық	N
пісіру	V
қаламқас	N
мыңдап	NUM
аруанадай	A
топ-топ	ADV
Жомартбек	N
басқадай	ADV
былтырғы	A
шипа	N
аналитикалық	A
жалмау	V
шығар	ADV
АҚШ	N
сапер	N
автомобиль	N
титтей	A
ізбасар	N
Танадай	N
америка	N
орнау	V
түк	N
колхоз	N
сабау	V
топтану	V
өшіктіру	V
аңдасу	V
шабыттану	V
күмістей	A
ынта-ықылас	N
жуасыту	V
күбі	N
қылмыскер	N
қызғылт	A
құрастырушы	N
патриотизм	N
бажылдау	V
сауырлау	V
жұмарлау	V
көпіршіген	A
асқазан	N
жүн-жұрқа	N
крест	N
пікірсайыс	N
құдірет	N
одан	PRO
әрең-әрең	ADV
сасқалақ	A
радиостанция	N
шолжаң	A
тергеу	N
бет-бетімен	ADV
алым	N
манап	N
бұғаз	N
атқыш	N
тағдыр	N
ағай	N
Тәтіқара	N
балл	N
Айтам	N
сырттан	ADV
почтамт	N
сырбаз	A
айықпай	N
кезеген	N
ұту	V
борщ	N
күтуші	A
әлсін-әлі	ADV
қалбалаңдау	V
Тілеуімбет	N
әуре-сарсаң	N
бәліш	N
субстантив	N
тоғысу	N
қаперсіз	A
сексеуіл	N
сумақай	N
тоғысу	V
ұсынылу	V
сезімдік	A
Иван	N
менмендік	N
сүйеу	V
еңбекақы	N
әдемілеу	V
ақшалай	N
орнықтыру	V
өткір	A
тікелей	ADV
асығу	V
омырау	N
жайраңдау	V
кешігу	V
ұйытқу	V
кілкілдеу	V
қайтарым	N
ата-ана	N
бұта	N
ылғал	N
ояну	V
ағатын	A
атала	N
көсемше	N
қырағы	A
саңырау	A
айдаһардай	A
асар	N
лаждау	V
нәтижелілік	N
Бұхара	N
сұрлану	V
алауыздық	N
Тұрғанқұлов	N
ақшам	N
батпақ	N
ысқылау	V
жап-жаңа	A
белсенділік	N
айыру	V
қыстыгүні	ADV
пейіл	N
үсті	N
мынандай	PRO
алдаушы	N
төлдеу	V
елегізу	V
бақсылық	N
өрік-мейіз	N
ақсүйек	A
кебіс	N
қашақ	N
кәсіби	A
тұтану	V
тікею	V
бадана	N
этика	N
қоюлану	V
ұлтаралық	A
берекелік	N
мал	N
сылбырлық	N
ін	N
редактор	N
паңдық	N
бағыну	V
мешеу	A
тақырып	N
кету	V
жасау	V
Яссы	N
ерлік	N
бастама	N
модель	N
көмкеру	V
мардымсыз	A
әжуалау	V
астамдық	N
белсенді	A
боқтау	V
теннис	N
эпидемиолог	N
жетпіс	NUM
тік	A
қалталы	A
есер	A
сүйсінген	A
насихаттау	V
маман	N
шашырау	V
құда	N
талаптану	V
бөдене	N
Қалиман	N
оғаш	A
мылжың	A
тілхат	N
қобдиша	N
қыз	N
суармалы	A
тәлімгер	N
шырқау	V
шалқақтау	V
дүниеқоңыз	N
ұйық	N
Айхан	N
еврей	N
новелла	N
анестезиолог	N
бөпе	N
Хұсайын	N
екінші	NUM
әпербақан	A
азғын	A
байланған	A
немесе	CONJ
корреспонденция	N
жинасу	V
кезену	V
ұзамай	ADV
жәннәт	N
сап	N
тұт	N
дана	N
әркез	ADV
жою	V
керең	N
қайтым	N
көнігу	V
оңаша	A
дана	A
үдеу	V
бұлғау	V
жөндеген	A
бозша	A
пенде	N
сәнқой	N
жарқырау	V
шах	N
ас-су	N
Еменалы	N
сәл	ADV
күйініш	N
Әсет	N
алқындыру	V
қанат	N
бейнетаспа	N
балерина	N
алимент	N
іреу	V
түбір	N
аластау	V
мақала	N
меңгеру	V
жайбарақат	ADV
дидар	N
тіптен	ADV
сарнау	V
шалдығу	V
биржа	N
бөгеу	V
аңқаулану	V
күлпарша	N
киногер	N
студент	N
пайдалану	V
қыспақ	N
бүйрек	N
тарам-тарам	A
жұбайы	N
құрылық	N
Самарқант	N
малайлық	N
жауыр	N
сиыр	N
табақтас	N
күштілік	N
абайсызда	ADV
сиыршы	N
тор	N
қаба	N
сықырлауық	A
тобарсу	V
улап-шулау	V
кредо	N
сопақ	A
төбел	N
ортаю	V
қарақошқылдану	V
жуықтау	V
шымшым	N
қуырдақ	N
ұран	N
самса	N
бұлқан-талқан	A
сүйену	V
тіс	N
бірегей	A
тұспа-тұс	A
бұлтақтау	V
елжіреу	V
дамбал	N
атқыштық	N
грамота	N
лүпіл	N
баса-көктеу	V
от	N
отарлау	V
эскиз	N
уату	V
разряд	N
тіркесу	V
алшақтау	V
бассейн	N
лампа	N
күтім	N
маржан	N
Астрахань	N
дағдылан	V
қоштау	V
жақсару	V
далалық	N
Қадылбай	N
киік	N
аңырау	V
сылақ	N
жеңіліс	N
сүйір	A
төстік	N
қалу	V
қатарлы	N
қымыз	N
оқылым	N
лицей	N
маңғаздану	V
сауыт	N
элемент	N
үркек	A
есерсоқ	N
ұшы	N
жақ	N
аз-кем	ADV
шірік	N
пайым	N
қате	A
қытық	A
қате	N
шірік	A
сыпсыңдау	V
шың	N
жылыту	V
қолайлы	A
шөмеле	N
сандырақтау	V
қайымдасу	V
оянбай	N
кемсеңдеу	V
кіреші	N
сартылдау	V
ажар	N
разъезд	N
абстракция	N
залал	N
тұспалдау	V
шекара	N
топтасқандық	N
атырау	N
бюджет	N
қыжыл	N
түйсік	N
аңғал-саңғал	A
қынжылу	V
үн	N
абайлау	V
төмпешік	N
апат	N
паң	A
төс	N
қазық	N
дымдау	V
сорап	N
қолтық	N
уәждеме	N
жаңғырту	V
жайрату	V
зейнет	N
атамұра	N
көтеріл	V
мирас	N
әдебиеттану	N
айырмашылық	N
саулық	N
талант	N
әурешілік	N
тақырыпша	N
ісік	N
тірілу	V
қазыналық	A
желке	A
километр	N
хан	N
Мұзбел	N
ысқаяқ	A
алтыншы	NUM
шапалақ	N
аптадай	A
кежеге	N
жиілік	N
жүндеу	V
мүшайра	N
қашу	N
жұмулы	A
неткен	A
қауіп-қатерлі	A
сексенінші	NUM
сазару	V
гинеколог	N
наным	N
қашу	V
күзелген	A
қожа	N
биыл	ADV
паралау	V
Ораз	N
күлімсіреу	V
сылдыр	N
нұсқау	N
үзбе	N
даушы	N
жинаушы	N
тапжылмай	ADV
айбын	N
милы	A
ілмиген	A
қарқындау	V
демократияландыру	N
аждаһа	N
адалдық	N
мынадай	PRO
толғату	V
өлшеулі	A
жарасымды	A
тесік	A
орындаушы	N
деңгей	N
автобус	N
еншілестік	N
советтік	A
мағына	N
сұлулану	V
дидактикалық	A
көрермен	N
бүтіндей	ADV
өнерпаз	A
нота	N
реңк	N
іріп-шіру	V
шеберлену	V
пысық	A
корольдік	N
құралай	N
ішкен	A
ақуыз	N
сипаттау	V
жинақы	A
жылдамдық	N
құрбақа	N
бөрту	V
өзімше	ADV
көмекші	N
қапалы	A
алжу	V
диірмен	N
тоқтау	V
байлам	N
шабыс	N
сүйреу	V
қадірлеушілік	N
төлке	N
қисын	N
қуаң	A
басы	N
ғылымдық	A
сүйем	N
адалбақан	N
Айдос	N
тәуелсіз	A
көкірек	N
маскүнемдік	N
масқара	N
шырыш	N
ескек	N
белдік	N
вокзал	N
қалтылдау	V
жабдық	N
фраза	N
қобалжу	V
қат-қабат	A
мынау	PRO
бүктеу	V
қосылыс	N
растау	V
байғұс	A
алба-жұлба	A
жақтыру	V
кенет	ADV
сыңар	A
жию	V
ысталған	A
құлаштау	V
мұздау	V
салмақты	A
тыңшы	N
серт	N
жұлқылау	V
құжаттама	N
тотыққан	A
кенже	A
биікте	ADV
көрсеткіш	N
киноаппарат	N
көнбіс	A
қырып-жою	V
сипаттама	N
бату	V
мысқал	N
Зейнеп	N
құнарсыз	A
қыртыс	N
сыйлау	V
Роза	N
сиқырлау	V
жадырау	V
аңсату	V
ақыл	N
бөлім	N
#lem	#lex
шынашақ	N
алпауыт	N
өндірісші	N
клас	N
қарш-қарш	IW
еп	N
ашытқы	N
өрлеу	V
бояу	N
ойнап-күлу	V
ұстану	V
зейнетақы	N
өрескел	A
жауап	N
тоғышар	A
бояу	V
дабылпаз	N
ақымақ	N
пысынау	V
шкаф	N
физиология	N
құмырсқа	N
ақымақ	A
әуре	N
анағұрлым	ADV
күресін	N
анықтату	V
тілмаш	N
еден	N
діндарлық	N
ғалам	N
транзит	N
қалампыр	N
жұму	V
қағида	N
шыны	N
мейманхана	N
бизнес	N
қатпарлану	V
алгоритм	N
шағала	N
трактор	N
шаш	N
дәріс	N
жүктеу	V
айнымас	A
тайынша	N
толықтыру	V
жиілеу	V
жортақтау	V
географ	N
сегіз	NUM
мосқал	A
шаршап	ADV
тудырушы	N
тарылу	V
тапанша	N
жарақтану	V
Симай	N
күрек	N
құты	N
болдыру	V
күйші	N
пішуші	N
кезік	N
саралау	V
құмыра	N
байлық	N
түрлі	A
қаламгер	N
сағалау	V
үгу	V
зерттеу	V
қошемет	N
ұсату	V
болымсыз	A
пайдалы	A
жекешелендіру	V
қынжылту	V
сөйлеуші	A
егесу	V
құранды	A
жып-жылмағай	N
сорлау	V
ортақтасу	V
сөйлеуші	N
педаль	N
резеңке	N
екеуара	ADV
значок	N
оппозиция	N
ызғыту	V
беттету	V
жар-жар	N
тәжірибе	N
күректеу	V
қоныстану	V
сыбану	V
тағу	V
болар-болмас	A
шаруашыл	N
беймазалау	V
бұжыр	A
бокс	N
әйтпегенде	ADV
қым-ғуыт	N
айдау	V
кепе	N
қуаттану	V
бақ	N
итермелеу	V
зыту	V
жайылмау	V
романтик	N
теру	V
мүйіз	N
сиқыр	N
киім-кешек	N
мәрмәр	N
сабақтастыру	V
бөрік	N
еңбекші	N
алды	ADV
тақтай	N
қимылдау	V
еңбекші	A
арашалау	V
нұқсан	N
жұқтырған	A
ышқыр	N
сатырлау	V
семестр	N
наразы	A
қатыгездік	N
жеңу	V
саятшы	N
шегіртке	N
кереге	N
Ақжол	N
далбасалау	V
Ренат	N
жоңышқа	N
пішенші	N
микроб	N
сәндеу	V
қосақ	N
бірізділік	N
ызбар	N
артықтық	N
Найман	N
әлди	N
мүмкін	ADV
таразы	N
анализатор	N
беріде	ADV
ауқаттану	V
парасаттылық	N
педагогика	N
үстелу	V
лықылдау	V
Каспий	N
тастай	A
заңсыздық	N
шығарылым	N
әрқашан	ADV
берілгендік	N
Саян	N
жиһаз	N
ұмытшақтану	V
әке-шеше	N
ұсақтау	V
қанаушы	N
фантазия	N
арашашы	N
жемсау	N
әлсіздік	N
аңдысу	V
сүйгіш	A
насыбай	N
көгерту	V
азалы	A
магистр	N
күлдеу	V
тұтыну	N
бойшаң	A
сату	V
өрелеу	V
түнету	V
әлдеқандай	A
кеңу	V
орайласу	V
көлденең	ADV
Нұра	N
уран	N
дікілдеу	V
мүмкіндігінше	ADV
Яссауи	N
шекер	N
қанағатсыздық	N
гильза	N
өзді-өзі	ADV
виза	N
ойлы	A
тоңғақ	A
қатпар	N
ілмелеу	V
шаңырақ	N
томар	N
заказ	N
сепаратизм	N
белдеме	N
мүгедектену	V
таңертеңнен	ADV
қарғап-сілеу	V
гастрит	N
еңіреу	V
шағым	N
айырылу	V
шамдану	V
азалау	V
жайнату	V
қаңылтыр	N
фон	N
дебют	N
мүгедек	N
тоқтық	N
бұлбұл	N
Жүсіпбек	N
күндік	A
көлеңке	N
оралу	V
қапалану	V
ой-қиял	N
аумақ	N
індет	N
ұлу	V
орны	N
тыңдамау	V
сәкі	N
тиелу	V
ыстық	A
қаныпезер	A
жетеу	NUM
іспетті	A
ара-арасында	ADV
малта	N
сығу	V
иін	N
жүргізуші	N
даңғырлау	V
түктену	V
шіге	N
дүкенші	N
аманат	N
сауда	N
ғұрып	N
тамызу	V
кекіре	N
бесінші	NUM
қисық	A
фирма	N
сұңғақ	A
табынушылық	N
шама	N
графин	N
доғал	A
даму	V
аумалы-төкпелі	A
табақша	N
жыра	N
лезде	ADV
ержету	V
Аққозы	N
тұрмыс	N
жұлқыласу	V
ләззат	N
монарх	N
бықпырт	N
қалған-құтқан	N
көсілту	V
түйістіру	V
өзгеріс	N
нық	ADV
қасқыр	N
қаралау	V
құйма	N
төте	A
жыпылдау	V
аздық	N
ояту	V
шақыру	V
тұту	V
дәйіс	N
тектоника	N
ағараңдау	V
экология	N
газдау	V
бақталас	N
ақыл-ес	N
қорасан	N
із-түзсіз	ADV
шәк	N
кеміткен	A
ұнамау	V
шариғат	N
бағдар	N
сиым	N
ғой	CONJ
озу	V
жұлдыз	N
талан-тараж	N
кезекші	N
арыс	N
көлегейлеу	V
қастық	N
лоблу	V
театр	N
иірім	N
мифологиялық	A
кекірею	V
тұқыл	N
сипау	V
радикал	N
қызыләскер	N
зиянкестік	N
бағыштау	V
Қобыланды	N
бітірмеу	V
шүбә	N
айқай-сүрен	N
өлтірілу	V
бұйым	N
халықтық	N
алғыс	N
маскүнем	N
адуын	A
мәдени	A
тентек	A
санкция	N
расымен	ADV
гуманитарлық	A
әмбе	PRO
қошқар	N
автопарк	N
грузия	N
тыныштану	V
ақырындап	ADV
бұйра	A
аграрлық	A
кірпі	N
қуғындау	V
шат	N
тату-тәтті	A
центнер	N
кемшілік	N
басқаратын	A
арты	N
ұшырау	V
келіспеушілік	N
бекер	N
жапырақтай	A
ыңқылдау	V
қыбырлау	V
заман	N
Cноуден	N
қарғадай	A
ілгергі	A
санау	V
атамзаманда	ADV
сіз	PRO
мық	N
қобди	N
алақандай	A
сүлде	N
хабарласу	V
мәжбүр	A
патент	N
балағат	N
күрмелу	V
шыңылдау	V
англия	N
күйтабақ	N
ширек	N
мойындық	N
инсульт	N
айтылатын	N
Мылтықбай	N
ботакөз	N
ауа	N
төселген	A
сырқат	N
компас	N
сыр	N
шырмау	V
сырқат	A
тілгілеу	V
үңілу	V
жыпылықтату	V
дау-жанжал	N
өрескелдік	N
тікірею	V
Шәріп	N
қазақстандық	A
ержүрек	A
назар	N
көсем	N
кузов	N
жаужүрек	A
өрнектелген	A
Едік	N
діріл	N
тігетін	A
алғаш	ADV
шіркей	N
көзделу	V
іркілу	V
көше	N
күңдік	N
епті	A
сақал	N
одақтас	N
семіз	A
батыру	V
зуылдау	V
Әбдуәлі	N
қолайсыз	A
ішек	N
құрау	V
башпай	N
ішек-қарын	N
мансап	N
құру	V
жетілік	N
жасақтау	V
шеше	N
шын	N
көптеген	ADV
шын	A
жұқару	V
үлек	N
лайсаң	A
тырна	N
тығыз	A
әліппе	N
таяудағы	A
қазір	N
инвестиция	N
терминологиялық	A
жамау	V
әлпештеу	V
шөп	N
ербеңдеу	V
жайқалу	V
азаптау	V
хрестоматия	N
Ғазиза	N
кинорежиссер	N
нала	N
торлау	N
салақ	A
томпақ	A
шыбық	N
күйкілік	N
балықты	A
бересі	N
кәсіпорын	N
қашанғы	A
парақ	N
кандидат	N
хирург	N
эпилог	N
албырау	V
қателік	N
қирату	V
шала	A
күнара	ADV
қойдыру	V
шала	N
былжырау	V
кенелту	V
қаршадайынан	ADV
сиысу	V
фактор	N
аржағындағы	A
жинақтау	V
жезөкше	N
азанама	N
сему	V
мораль	N
бұрқырау	V
ұнау	V
табыстылық	N
магистраль	N
әлдеқайдан	ADV
қарқын	N
тамақтану	V
жарылқау	V
тудыру	V
қолөнер	N
көнтерілі	A
аңсырау	V
қатерлі	A
көрші	N
көрме	N
қастерлеу	V
бұлай	PRO
мұңайған	A
жомарт	A
саясат	N
ізеттілік	N
жазушы	N
мөлдіреу	V
Төкей	N
жағармай	N
қабылдану	V
химик	N
кейіпкер	N
жеткіншек	N
теңіз	N
қосымша	A
мүсіркеу	V
табан	N
циклон	N
ирелеңдеу	V
қамқоршылық	N
Дуанабай	N
көкшіл	A
топан	N
тиесілі	A
үйлесім	N
өртенген	A
арқалату	V
берешек	N
минут	N
қалбалақтау	V
жат	A
бекініс	N
шашыраңқы	A
құлдау	V
ойыншық	N
этажерка	N
мола	N
ерекше	A
қырқу	V
туысу	V
іріген	A
ата-мекен	N
социология	N
сал	N
зеку	V
сайран	N
бүлдіру	V
майбалық	N
тұлымшақ	N
герцог	N
безу	V
қолданбалы	A
сыбау	V
өңір	N
қызылдар	N
шахта	N
жоқтау	V
шыбындау	V
тіміскілеу	V
мықын	N
айқайлау	V
анталау	V
ауыздану	V
қыңқылдау	V
тізбектеу	V
қалалық	A
құсни	A
қарасу	V
сезімділік	N
қалшылдап	ADV
Жаған	N
жанама	A
жорамал	N
менсінбеген	A
туғызу	V
құштар	A
сыйдыру	V
уайым-қайғы	N
мақам	N
жыбырлау	V
тоңазу	V
тындыру	V
бөтелке	N
көндігу	V
тәйт	INTJ
снаряд	N
тірелу	V
сосын	ADV
көйлек	N
жаңашылдық	N
кереңдік	N
күтір	N
саяхаттау	V
алдында	ADV
лирикалық	A
Шалабай	N
жүдеу	V
тапшы	A
атастыру	V
там	N
құйрықсыз	A
науа	N
мерез	N
ету	V
ара	N
арқалы	A
тояттау	V
шырша	N
алма	N
бастаңғы	N
жариялылық	N
қорқау	N
ақбөкен	N
академия	N
Айтқали	N
оңай	A
сырт-сырт	IW
шегіну	V
денелі	A
аяныш	N
қанжыға	N
бұзылмау	V
Әмина	N
дыбыстау	V
альянс	N
баяндамашы	N
Тоқтаров	N
тайраңдау	V
тұздық	N
ересек	A
сызба	A
үркер	N
қалаулы	A
оперативті	A
құпия	A
аттестациялау	V
жады	N
сол	A
шикі	A
ішік	N
қоғалы	N
бірбеткей	A
тәй-тәй	INTJ
түсініксіз	A
азиялық	N
балқу	V
кеніш	N
қоспақ	N
домбыра	N
мөлшерлеу	V
апалаң-топалаң	N
жүйке	N
ою	V
сарғаю	V
екшелеу	V
тас-талқан	N
әйтеуір	ADV
төңірек	N
пұт	N
сырлы	A
Ташкент	N
ағым	N
қолтықтау	V
шара	N
олимпиада	N
найзагер	N
инженерлік	A
шалғайлану	V
бағдарлау	V
аналық	N
қаңбақ	N
кредит	N
секретариат	N
жеңіс	N
ертек	N
төбелес	N
қатпа	A
бықсыма	N
сіресу	V
мекірену	V
жетік	A
шылау	N
түпкілікті	A
сипалау	V
сырлау	V
аяқтану	V
төтенше	A
феодалдық	A
қиқар	A
үлгерім	N
дөкір	N
шіркеу	N
ұйымдастырушылық	A
шіркеу	A
экономикалық	A
препарат	N
көпір	N
мойымау	V
дабырау	V
төну	V
шегеру	V
сүйіс	N
қазан-ошақ	N
геолог	N
үйрек	N
ұмар-жұмар	N
дәлел	N
хайуанат	N
саналы	A
ант	N
окоп	N
печенег	N
дүмпу	V
иіскелесу	V
ылди	N
топ	N
шегініс	N
алты	NUM
алмастыратын	A
көну	V
иілген	A
мембрана	N
болмашы	A
тыққыштау	V
азанғы	A
Таңатар	N
жәрдемші	N
мейман	N
бояр	N
таратушы	A
ғажап	A
жомарттық	N
күдері	N
мұқау	V
жындылық	N
кемел	N
азар	N
көмекші	A
Басеке	N
күшейту	V
бейнет	N
ұпай	N
азаматтық	N
мамандық	N
контрабанда	N
ма	PART
садақа	N
зерттеуші	N
предикат	N
садизм	N
шегіргүл	N
көсеу	V
оңтайлы	A
қалжыңшыл	A
меруерт	N
дәнеңе	N
дау	N
жазалаушы	N
әуе	N
ұласу	V
сақтаулы	A
бергісіз	A
мүрит	N
жалтақтау	V
меншік	N
гектар	N
беруші	N
кандидатура	N
астаудай	A
типыл	A
келбет	N
девальвация	N
жуастық	N
қақпақыл	N
тілемсектік	N
жапа	N
тобыр	N
қалақ	N
үйінді	N
өзінше	N
қауіпсіздік	N
зеңу	V
орашолақ	A
іскерлік	N
жоталы	A
фонтан	N
жетекте	V
күндесу	V
жұмыртқа	N
рәсуа	N
дос	N
ақсию	V
зая	N
тұқырту	V
зачет	N
неше	PRO
реніш	N
сүйгізу	V
тиген	A
саясатшыл	N
я	CONJ
өлкетанушы	N
торығу	V
зұлмат	N
сәресі	N
қаңтару	V
қошқыл	A
жерлес	N
күйеу	N
мушкет	N
мәуелі	A
аффикс	N
анықтауыш	N
есептік	A
лала	N
ерлі-зайыпты	N
Қанжығалы	N
үгілмелі	A
көшірілу	V
химиялық	A
аяулы	A
шіріген	A
үскірік	N
коммунистік	A
аяғыш	A
қарысу	V
түге	N
шаттану	V
дарбаза	N
түндік	N
коридор	N
қатпарлы	A
аман-сау	ADV
зұлым	N
жиектеу	V
талмастан	ADV
күшіген	N
сүйту	V
барқырау	V
тоғызыншы	A
өлшеп-пішу	V
айығу	V
мең	N
журналистика	N
Садабек	N
кектеу	V
жаттату	V
корпус	N
ойлау	V
салалық	A
мавзолей	N
торсықтай	A
тесу	V
астрология	N
полигон	N
жұмсақ	A
зарықтыру	V
мұң-зар	N
жарамсақтану	V
арындау	V
ұялмастан	ADV
топса	N
ұрланып	ADV
елек	N
бірдей	A
арғы	A
көргенділік	N
толық	A
бесін	N
әсірелеу	N
балқыту	V
жалпылау	V
таң	N
қалам	N
хирургия	N
баллада	N
түстену	V
ер-тұрман	N
бірқалыпты	A
лай	A
қылжақбас	N
бензин	N
опера	N
лай	N
Мұхаммед	N
мінездеу	V
жеңгей	N
қиындық	N
Нұршайықов	N
ауру	A
еліктеу	V
ауру	N
ертеңгілік	N
Бұрындық	N
күпшек	N
көкірек	A
та	CONJ
жүзген	N
тойлау	V
нәресте	N
бақтыру	V
дағдару	V
шоңқаю	V
алмасу	V
сабындау	V
модуль	N
бозаң	N
бүрсігүні	ADV
имандылық	N
күс	N
жез	N
тексеріс	N
эквивалент	N
тірлік	N
клавиатура	N
қайыра	ADV
күнделік	N
сынаптай	A
пән	N
жеткізуші	N
тұну	V
тұщы	A
жол-жөнекей	ADV
бағлан	N
сілку	V
сықақтау	V
қорықпайтын	A
сақшы	N
барғыштау	V
композициялық	A
жоқ	PART
дамыған	A
қарақұс	N
тұтқиыл	ADV
байсалды	A
материал	N
қуаттылық	N
дөнен	N
мәсі	N
ру	N
аруана	N
негатив	N
транспорт	N
құса	N
қошқылдану	V
өлердей	ADV
ауыздықтау	V
уағыз	N
мылтық	N
ауысым	N
қазалы	A
бап	N
медицина	N
жала	N
арсылдау	V
жорыма	N
біртектес	N
Махмуд-Сұлтан	N
аю	N
зауық	N
шақырлау	V
ақпейіл	A
аруақай	A
сұраушы	A
үй-іші	N
зекет	N
желмая	N
қуғын-сүргін	N
улау	V
шиеленісу	V
балауыз	N
гинекология	N
маусым	N
кес-кестеу	V
әзілдесу	V
етік	N
сақтық	N
жегізу	V
нарттай	N
серуендеу	V
қолайсыздық	N
ық	N
торқалы	A
өңдеу	V
дауылдау	V
Андижан	N
бүркіт	N
энергия	N
сең	N
кездейсоқ	A
патруль	N
кіргізу	V
білместік	N
қалың	A
томаға	N
большевик	N
индикатор	N
ентікпе	N
шпион	N
жәндік	N
омыраулау	V
әзіл-шыны	ADV
шаруашылық	A
балшықтау	V
артынып-тартыну	V
аманшылық	N
құт	N
қайтеді	N
бостық	N
Байдалы	N
нұсқаулық	A
ақалтеке	N
үзілу	V
белгілі	A
қозғалмау	V
салют	N
қар	N
міну	V
ауыз	N
Әуенов	N
үстемдік	N
тақыр	A
қалауынша	ADV
қыздық	N
еңбеккүн	N
Есеке	N
ой-қыр	N
жібіген	A
базарлау	V
аласа	A
генетика	N
қоңырау	N
флотилия	N
лениншіл	N
бөліну	V
илену	V
қарулы	A
сорақылық	N
жексұрын	N
рефлекс	N
қарашық	N
балет	N
арзандық	N
жұмсару	V
Александр	N
кендір	N
ақсаңқырау	V
бетоншы	N
жынды	A
асқар	A
инженер	N
кеміру	V
шаян	N
компетенция	N
төрелік	N
эшелон	N
кеудеше	N
самарқау	N
мақпал	N
пара	N
ұмтылу	V
қайыс	N
көлемдік	N
талапкер	N
заявка	N
жамандық	N
дақ	N
медеу	N
литва	N
теміреткі	N
үйлесу	V
көшір	N
турау	V
көнек	N
шұбалту	V
таму	V
шыпшу	V
қалжырау	V
іскен	A
текше	N
келеке	N
қарқындылық	N
есеңгіреу	V
шоңқайма	N
жетекші	N
сауда-саттық	N
бақыраю	N
жасқану	V
шақар	A
диқаншылық	N
озбыр	N
сәске	N
өлеңдету	V
бухгалтерия	N
ұқсас	A
жарма	A
әмір	N
жауын	N
үздік	A
қатарлау	V
жусау	V
сүргілеу	V
мосқалдану	V
өсек-аяң	N
ақжүрек	A
Құрмаш	N
жайлы	A
дойбышы	N
таңырқану	V
тәубе	N
қимыл	N
ажырату	V
тық	N
таңсық	A
Жексен	N
киелі	A
жолдама	N
физикалық	A
қабілет	N
пір	N
қайта	N
зорлап	ADV
арыз	N
айбатты	A
жүгіну	V
нарық	N
қаттылық	N
араласпау	V
тыңдау	V
әнтек	ADV
алдап-сулау	V
безену	V
борбай	N
мүрде	N
шілде	N
теория	N
гипертония	N
біреу	PRO
ұрлату	V
пәнаралық	A
абыржыған	A
пұшпақ	N
қабаттасу	V
іс-әрекет	N
ортақ	A
бейнеленген	A
адвокат	N
ауру-сырқау	N
тегіс	A
жетекшілік	N
жаппай	A
өлі	A
жігіттік	N
теңеу	V
қиыршықтау	V
айқындалу	V
асқабақ	N
теңеу	N
қайырлау	V
бажалақтау	V
старт	N
қалта	N
аңтарылу	V
ақысыз-пұлсыз	A
бес	NUM
тәрбиеші	N
ым	N
тері	N
қазақ	N
Ырғыз	N
мысалдау	V
құрық	N
медаль	N
мөңку	V
Көшен	N
дойыр	N
перрон	N
ыдыс-аяқ	N
Сауд	N
бәйшешек	N
бағыт-бағдар	N
бомбалау	V
торап	N
атау	V
өнегелі	A
тиын	N
капуста	N
партия	N
надан	N
Бердібек	N
надан	A
ынталандырушы	A
мадьяр	N
теңгеру	V
қорқыныш	N
тектес	A
депо	N
бағалайтын	A
қарсы	ADV
блок	N
құдай	A
комбинезон	N
башқұрт	N
жігерлі	A
мөңіреу	V
құймақ	N
салмақ	N
поселке	N
пақыр	A
Ауғанстан	N
оңашалау	V
қасқалдақ	N
арс-арс	N
өрбу	V
дүре	N
жап-жақсы	A
аспан	N
тартымды	A
мұқияттылық	N
Мұхамед-Мазит-тархан	N
кесім	N
көкшілдену	V
жөнелу	V
рақмет	N
шыбыш	N
Зиманов	N
шелек	N
тағзым	N
шытырман	A
альбом	N
көкпеңбек	A
қылмыңдау	V
астасу	V
ақырындау	V
спортшьы	N
топырақ	N
өлкетану	N
пырылдау	V
мысал	N
темірші	N
атыз	N
сайқалдық	N
күмбірлеу	V
хабардар	A
тоған	N
эвакуация	N
пәлеқор	A
антологиялық	A
ожар	A
пысу	V
мақсаткерлік	N
зайыптылық	N
ішкері	ADV
шамалап	ADV
азаматша	N
қорытпа	N
жұлқу	V
әдістеме	N
лаборатория	N
жеткілікті	A
ықшамды	A
сұраулы	A
кешу	V
титықтау	V
желпілдеу	V
вариант	N
жамырау	V
іліктіру	V
ассоциация	N
айырту	V
азайту	V
баяндама	N
қартаң	A
жарарлық	A
майланатын	A
салбырау	V
тысқары	ADV
өнертану	N
жалыну	V
тасушы	N
қуану	V
Әмірбекұлы	N
аялдасу	V
бүрген	N
шаңқылдау	V
жанталасу	V
пұшық	A
рызық	N
қайнар	N
шөпшек	N
жорға	N
қырым	N
композитор	N
Дариға	N
әсем	A
философ	N
жылдық	N
құйқылу	V
гүрсілдеу	V
қауесет	N
азаю	V
игілік	N
жәдігөйлік	N
тарихнама	N
кодекс	N
бөлектеу	V
қинау	V
құсық	N
белсену	V
аңқылдау	V
бозғыл	A
сіріңке	N
шұлық	N
қияңқылық	N
юбка	N
Мүрси	N
шойын	N
шылдырау	V
қарызгер	N
шырамыту	V
аяғында	ADV
сыбағалы	A
күдікшіл	A
кезеру	V
мұз	A
санитарлық	A
көгілдір	N
каюта	N
позиция	N
аунап-қунау	V
ыңырану	V
Қамбар	N
ауылшаруашылық	N
вальс	N
жүгірту	V
модернизация	N
ауылшаруашылық	A
жалпыхалықтық	A
тәкаппар	A
нұқу	V
еңбек	N
нұсқаушы	N
оқалау	V
қарақошқыл	A
түскі	A
қоқақтау	V
өзбек	N
Сүйіншік	N
тереңдік	N
Бауыржан	N
түйілген	A
жанаргүл	N
кеуек	N
еліктіргіш	A
құйқалы	A
мырза	N
айып	N
потенциал	N
ескілікті	A
күн	N
минерал	N
жуа	N
салпы	A
пәрмен	N
желдету	V
жаттығу	N
эскадрон	N
ислам	N
Марат	N
қаржы	N
істес	N
тұрақтандыру	V
сауатсыздық	N
жаттығу	V
көрмеу	N
кресло	N
механизм	N
картоп	N
демократия	N
шектелген	A
өкпе	N
өкпе	A
қалтырап	ADV
тық-тық	N
салқындау	V
беймезгіл	N
кесене	N
аренда	N
қарауыл	N
төлемеу	V
қоныстас	N
қопсыту	V
басу	V
терлеу	V
апорт	N
бұрау	V
жалмауыз	N
агентура	N
бактерия	N
босқын	N
қараңғы	A
ынталы	A
өлгенше	ADV
опат	N
түнек	N
құсбегі	N
саптама	N
әзірлеу	V
пароход	N
кідіру	V
анализ	N
түзелген	A
сену	V
тенденция	N
тартымдылық	N
жыра-сай	N
бары	N
тақия	N
қауырт	A
атмосфера	N
гүріл	N
астыртын	A
ондық	NUM
емшілік	N
Меркі	N
білезік	N
уақытша	A
жартылай	A
сақина	N
қадірлі	A
өрнектеу	V
нәтиже	N
берілу	V
құрт	N
азып-тозу	V
теңестірілу	V
топтастыру	V
кеспе	N
құрам	N
шынтақ	N
жөңку	V
жіпсу	V
елшілік	N
сусылдау	V
ағадай	N
отряд	N
төменнен	ADV
қандауыр	N
тиін	N
аран	N
тәсіл	N
төпеу	V
қыдыру	V
ұлан-асыр	A
тіркесім	N
артпа	A
бұлақ	N
кыс	N
Манарбек	N
жақсылау	V
ағайындас	A
жиын	N
мырзалық	N
санақ	N
химия	N
табиғат	N
беталыс	N
түбіртек	N
печенье	N
герб	N
өскен	A
тауқұдірет	N
қожайын	N
өнер	N
біткенше	ADV
нәзік	A
хал-жай	N
дар	N
балабақша	N
платина	N
пысқыру	V
ызғарлы	A
қақырау	V
флот	N
кең	A
тыну	V
иілгіш	A
даттау	V
алша	N
көзқарас	N
Баһадур	N
сақ	A
шығу	V
экзамен	N
басқа-басқа	A
айлақ	N
күпір	N
айбарлану	V
делегат	N
жал	N
шеңгел	N
іскер	A
жинату	V
талқандау	V
нығаю	V
кекіл	N
жауаптылық	N
әжептәуір	A
тәж	N
ілгері	ADV
қоса	ADV
қыршу	V
автобаза	N
деу	V
ағызу	V
дәлелдеу	V
халайық	N
қаһарлану	V
мазмұны	N
қайраттану	V
қырнау	V
Байтұрсынов	N
шолу	N
жабысу	V
Ақтөбе	N
радиоқабылдағыш	N
ұшқыр	A
төркін	N
елеу	V
бажылдауық	N
көбіктену	V
ұста	N
үйкеу	V
сәбилік	N
ризалық	N
тартыс	N
қиналған	A
айқай-шу	N
әлдилеу	V
шыдау	V
ерсілік	N
алтын-күміс	N
саршұнақ	N
антропология	N
өсек	N
қақтығыс	N
қайрау	V
жайылма	N
айла-әдіс	N
бұтақты	A
жағымпаздық	N
барымталау	V
аласару	V
ғалымдық	N
риза	INTJ
қызғаншақтық	N
итбалық	N
қалжыңбас	A
дәстүрлік	N
қарыстау	V
кіріс	N
беру	V
шуылдау	V
қулық	N
бұйдалау	V
тоспа	N
айқастыру	V
оятар	N
қасапшы	N
бекзада	N
империализм	N
жайласу	V
кедейлену	V
бірауыздылық	N
алтыбақан	N
қашық	A
кеңістік	N
кірпіш	N
шет	N
кірлеу	V
Кенесары	N
сәтен	N
ар	N
қырғыз	N
емдеу	V
өткізетін	A
тығын	N
түйіндеу	V
несеп	N
қатыс	V
өркендеген	A
малтығу	V
айну	V
егеуқұйрық	N
ниеттес	A
жармасу	V
ортақтық	N
пәуеске	N
ми	N
балпақ	N
алма-кезек	ADV
түн	N
бөстек	N
бақыршы	N
айыптаушы	N
ауу	V
құрал-сайман	N
застава	N
келісім	N
есепші	N
бүтіндігі	N
белгісіздік	N
Тевкелев	N
жүйріктік	N
литвалық	N
қиялау	V
біржола	ADV
мұқият	ADV
пысыл	N
мүйіздеу	V
лазер	N
тиісті	A
президиум	N
таза	A
сылтау	N
тістеу	V
жиырмасыншы	NUM
одан-бұдан	ADV
рұқсат	N
параллель	N
бәлсіну	V
аптықпа	A
мөлшерлі	A
Тоба	N
азаттық	N
анығында	INTJ
валюталық	A
жазу	V
Меңтай	N
бұлтару	V
албырт	A
әулие	A
қош	INTJ
шырай	N
түрткілеу	V
Төреғали	N
біріктіру	V
бесік	N
ирек-ирек	A
жаңашыл	A
биіктік	N
қайда	N
ғалым	N
көрсету	V
шеңбер	N
ерттеулі	A
қол	N
граната	N
атойлау	V
ағайындық	N
екі	NUM
сүмбіле	N
кербұғы	N
Қашқар	N
жер	N
ышқыну	V
қанағатшыл	A
аң-таң	ADV
студия	N
Шалдуар	N
бейнелі	A
Жәдігержан	N
әлеуметтік-мәдени	A
мұржа	N
солтақтау	V
жиырма	NUM
әтір	N
айырғысыз	A
баулау	V
өкіметшіл	A
көзінше	A
баржа	N
шиқан	N
ысыту	V
өкше	N
взвод	N
ондай	A
ойын	N
әліп	N
дүркіреу	V
таныс	A
сіркіреу	V
қора	N
сиқырлы	A
палата	N
бүйе	N
бұтақтау	N
барс	N
қошеметтеу	V
жексенбі	N
қаралық	N
шаңғы	N
табандылық	N
марқаю	V
ошаған	N
жұпардай	A
қанар	N
бітеу	V
керім	A
түтікше	N
құртатын	A
жарылу	V
Күнсана	N
малдану	V
едіреңдеу	V
жазықты	A
кабинет	N
қонжию	V
дискуссия	N
бұзақылық	N
цифр	N
абыржымау	V
емізу	V
сауыт-сайман	N
Тасыған	N
жөн-жоба	N
бухгалтер	N
сүзгілеу	V
алпамыс	N
құюлы	A
қауышу	V
зор	A
ілгерідегі	A
шертер	N
ойысу	V
Дауылбаев	N
аммиак	N
өш	A
бұзық	A
бүлкілдеу	V
бұзық	N
жорыту	V
комиссар	N
заулау	V
сау	A
көкетай	N
жарнама	N
осында	ADV
қосылу	V
қанаттану	V
қылыштау	V
сергелдең	N
ірге	N
мінезді	A
атаушы	N
ұрық	N
зораю	V
жариялаушы	N
шыжылдату	V
тізім	N
долбарлау	V
орау	V
жап-жасыл	A
ахуал	N
жайнау	V
қоздау	N
ежелгі	A
қылдай	A
жылжу	V
металлургия	N
Алтаев	N
лайлы	A
қарлы	A
мешін	N
қалай	PRO
туыс	N
айналсоқтау	V
айналма	A
оттау	V
қайралу	V
қиялдау	V
баж	N
орынбасар	N
қабырғадағы	A
Калинин	N
жоғарылау	V
ауыртпалық	N
құжат	N
әлем	N
сүйіспеншілік	N
қызғалдақ	N
көтерілу	V
тәлім	N
құдайсыз	N
қаңғу	V
тыйым	N
қозғаушы	N
ырық	N
мұндай	PRO
жылдамдату	V
пломба	N
түйіскен	A
шошырлық	A
күбірлесу	V
жуынды	N
сірге	N
иіру	V
шешен	A
ізденген	A
Қазтуған	N
гүл	N
босаң	A
бозамық	A
арсыздық	N
көмір	N
ландыш	N
ащы	A
мүсәпір	A
сырық	N
тозаң	N
график	N
міндеттеме	N
қамалған	A
мүсәпір	N
алап	N
ызғарлану	V
торы	N
дауылдай	A
ұятсыздық	N
рең	N
айбат	A
ызалы	A
айыпкер	A
үгітші	N
шулау	V
жейде	N
басқаша	ADV
лактау	V
байлау	V
тасымал	A
эксплуатация	N
белсіздік	N
естелік	N
сезімтал	A
аша	N
бұрнағы	ADV
көкжөтел	N
терлеген	A
қорғалақ	N
бал	N
латыш	N
лингафон	N
жаман	A
архаизм	N
келемеждеу	V
ұтқыр	N
бұқаралық	A
жанкешті	N
сағаттық	A
самолет	N
жапсыру	V
ғылым-білім	N
нәпсіқұмар	A
бұрынғыдай	ADV
жұлым-жұлым	A
ыңырсу	V
тапсырыс	N
отаншылдық	N
ызың	N
Науан	N
пәтер	N
стиль	N
көмектесу	V
тайталасу	V
тәрбиелік	A
кремль	N
балға	N
акушер	N
насихат	N
текіректеу	V
Есімов	N
әзірейіл	N
есірткі	N
әрекеттесу	N
станция	N
қоламта	N
қанау	V
түгел	ADV
көлеңкелеу	V
өкілетті	A
қисайту	V
бүтін	A
сасыр	N
тайсалу	V
құнттылық	N
қарғау	V
бұхарлық	N
күпі	N
келді	V
болмыс	N
сылтаурату	V
осынша	ADV
құрбы	N
қабылдамау	V
обал	N
жатсыну	V
қайнау	V
басқарма	A
бригада	N
адастыру	V
қоңқаю	V
тамырлану	V
атқылау	V
теңізші	N
сайқымазақ	N
аяңдау	V
сауғалау	V
қаһар	N
ақылсыздық	N
сару	V
тепе-тең	A
салт	N
бірден-бір	A
құсу	V
тиянақталу	V
көрсетім	N
революциялық	A
қабығы	N
қонымды	A
тістену	V
ойламай	ADV
қара	A
қаталдық	N
қас	N
жұмсалу	V
қас	A
құқық	N
арбию	V
сор	N
дублет	N
Окинков	N
шоқаю	V
тәмпіш	A
долдану	V
диссертация	N
ханзада	N
еру	V
Латиф	N
географиялық	A
Бозтайлақ	N
толқын	N
бидай	N
кіріптар	A
тұзақ	N
дирижер	N
депутат	N
жоңғар	N
пациент	N
толғау	N
кимешек	N
өзгермелі	A
дзот	N
бермен	ADV
жұлмалау	V
кран	N
ескерткіш	N
әңгімеші	N
үйрету	V
шеп	N
еркіншілік	N
саят	N
аяқтандыру	V
шұбалу	V
шатпақ	N
баритон	N
едірейту	V
дәлелдеме	N
пәле	N
жүйе	N
адвокатура	N
күту	V
қорғану	V
медет	N
ұя	N
апару	V
радио	N
намыс	N
патрон	N
қыналу	V
самал	N
шприц	N
маңыз	N
жасықтану	V
арақ-шарап	N
Нұржан	N
конъюнктура	N
Сергей	N
шаңдақ	N
жетімдік	N
пессимизм	N
алабұға	N
тыл	N
ниеттестік	N
далақтау	V
күмістету	V
рухани	A
сергек	A
шыжың	N
перзент	N
керек-жарақ	N
өтетін	A
ефрейтор	N
жұлдызша	N
аноним	N
өмір	N
нүкте	N
төр	N
е	INTJ
перде	N
бөгелек	N
білгізу	V
дәптер	N
қалтарыс	N
ақбоз	A
талану	V
саяхат	N
кіжіну	V
қоштасарда	ADV
тыңғылықты	A
кіру	V
тоттану	V
синтаксис	N
шамырқану	V
қабақ	N
одақтасу	V
керек	V
трамвай	N
логопедия	N
түбінде	ADV
қайырымдылық	N
оған	PRO
жалындау	V
ноғай	N
асаудай	A
борозда	N
туып-өскен	A
бұлыңғыр	A
Бөкей	N
кептіру	V
кішкене	A
танымдық	A
бүрме	N
ағамдай	N
таймау	V
матаулы	A
батырақ	N
бейқам	A
дәрежелі	A
қазандай	N
бейімділік	N
мамық	A
әурелеу	V
қондырғы	N
икем	N
жым-жырт	N
ботқа	N
алагеуім	N
омақасу	V
безектеу	V
қирата	ADV
тербелту	V
Моңғолия	N
аптап	N
Шайхыұлы	N
аздау	N
архитектура	N
некен-саяқ	ADV
колхозшы	N
төмендеу	N
үшкіру	V
жалтақтаушылық	N
ағалы-інілі	N
құрбандық	A
құрбандық	N
Церен	N
жақұт	N
амбулатория	N
сирек	A
жұртшылық	N
төмендеу	V
прогрессивтік	A
тракторшы	N
өре	N
айбалта	N
грамматика	N
бит	N
барлау	V
іркілмей	ADV
қабаттау	V
сүмірею	V
лирик	N
ішкілік	N
шешуші	A
эмбрион	N
қыстай	ADV
стратегиялық	A
кенелу	V
төтеу	V
ойдым	N
заңдылық	N
талмай	ADV
оттек	N
универсиада	N
импорт	N
емірену	V
әдебиетші	N
монша	N
тәрбие	N
сілекей	N
жерік	N
меңіреу	N
қаңсылау	V
журналист	N
бүркену	V
тірілей	ADV
достасу	V
шошу	V
толқындау	V
өнерлі	A
дала	N
сойыс	A
митингі	N
жолығу	V
паровоз	N
ораза	N
тиісу	N
әзәзіл	N
темір	N
масыл	N
тиісу	V
жиі	ADV
бас	N
революция	N
темір	A
жол-жора	N
калория	N
практикалық	A
алды-артына	ADV
шенеу	V
әккі	A
Қызылжар	N
жіліктеу	V
қиғаштап	ADV
зілзала	N
арылту	V
консультант	N
Жайық	N
демдеу	V
үлкен	A
Телегей	N
сәтсіздік	N
озбырлық	N
әккілік	N
әлдекім	PRO
балтыр	N
брондау	V
түсіндіруші	N
байтақ	A
терме	N
талу	V
қалайы	N
батырлық	A
бәкене	A
мә	INTJ
түкірік	N
парапар	A
лирика	N
папка	N
велосипед	N
күй	N
бейшаралық	N
салыңқы	A
бұртыңдау	V
этимология	N
платформа	N
бірсыдырғы	A
ар-намыс	N
Бақытжан	N
ауыспалы	A
бұлдырық	N
төреші	N
дарқандық	N
амандаспау	V
торсық	N
жарасу	V
термометр	N
бағбан	N
дәрі-дәрмек	N
бақытсыздық	N
қалжыңқой	N
қысқасы	PARENTH
шеткері	ADV
жоғары	ADV
аз	ADV
аттау	V
үкімет	N
зорлық	N
нәр	N
көріскенше	PARENTH
ымырт	N
резерв	N
шымырлау	V
шүйгін	A
репрессия	N
трагедия	N
шаң-шұң	N
мода	N
жау	A
ысқыру	V
ұқыптылық	N
айт	N
жалы	N
қуаңшылық	N
қажы	N
көптен	ADV
көктем	N
тұтқа	N
алтындай	A
адамша	ADV
оқ-дәрі	N
садақ	N
шүйке	N
халықшыл	N
матау	V
тұрақтау	V
тана	N
жаялық	N
Олжабай	N
тәлкектеу	V
Мұңлы	N
қыңыр	A
жүрдім-бардым	ADV
дүркін	ADV
жанқиярлық	A
аристократ	N
училище	N
ауылдас	N
сылу	V
итаяқ	N
география	N
сая	N
оқыған	A
иректеу	V
зейнеткер	N
драмалық	A
реттік	A
мұхит	N
бөтен	A
көптік	N
бұғы	N
мақтану	V
пеш	N
баян	N
паспорт	N
жырлау	V
субъект	N
аэроплан	N
аталу	V
меңдуана	N
қорылдау	V
сұрану	V
Қазақстан	N
астар	N
сылту	V
әлеміштеу	V
жүзу	V
қауыз	N
қант	N
ұрсу	V
принцип	N
күшею	V
сенімді	A
поэтикалық	A
қиыстыру	V
үркектік	N
қапшық	N
парақша	N
жойылу	V
Мұхамед	N
радиатор	N
қалқалау	V
шорқақ	A
қан	N
құмартқыш	A
жадау	A
кішіпейілдік	N
Раптан	N
өсім	N
ығысу	V
биязы	A
қайнатым	N
өте	ADV
жігіт	N
тапал	A
макет	N
алшы	N
операция	N
отызыншы	NUM
мәтел	N
демігу	N
жоспар	N
суық	A
сыршылдық	N
сұралу	V
пальто	N
етпеттеу	V
сона	N
жындану	V
құл	N
төбелестіру	V
күрес	N
вице-президент	N
мергендік	N
құдандалы	N
үйеңкі	N
арқырау	V
натуралды	A
кәсіп	N
достық	N
лас	A
нағыз	A
аруақ	N
сіңу	V
сәулеттік	A
аңғалдық	N
булық	N
қаһарман	A
алуан-алуан	A
қалдырмай	ADV
Ошақбаев	N
дірілдеу	V
шағыстыру	V
әдепкіде	ADV
қақсау	V
айырма	N
зым-зия	N
әлек-шәлек	ADV
қажет	N
жасаушы	N
үшеулеу	V
тағатсыз	A
солдат	N
шегу	V
жүгендеу	V
алабұрту	V
конспект	N
бекіту	V
итжидек	N
жиду	V
бөрі	N
қарақұрт	N
боталы	N
сатқындық	N
жаралану	V
қыстау	V
артында	ADV
бесаспап	A
мармелад	N
катер	N
рет	N
шолақ	A
толғану	V
зындан	N
буындау	V
батылдық	N
қарыз	N
өнеркәсіп	N
бөктер	N
ер-азамат	N
безектету	V
қошеметшіл	N
абыройлы	A
сулану	V
қыңсылау	V
атақ	N
тәуекел	N
Шапқан	N
қоңыр	A
таяу	A
алшаң-алшаң	A
матасу	V
түтін	N
бегемот	N
қоқаю	V
шор	N
асты-үсті	ADV
белең	N
матч	N
түңілту	V
қабаған	N
те	CONJ
жіліншік	N
Кеңесбаев	N
октава	N
момын	A
жазатайым	N
уытты	A
қопару	V
жазалау	V
проза	N
артиллерист	N
аппарат	N
дүбір	N
науқас	N
бейхабар	A
сайыс	N
айшық	N
қыраулану	V
сауал	N
озат	N
таптық	A
ағаштай	ADV
тәуке	A
акт	N
білу	V
өңдеуші	N
кірбік	N
галстук	N
шынтақтау	V
сұрақ	N
аңсау	V
тайқу	V
дивизия	N
ауыртатын	A
дөңгелеу	V
айқай-ұйқай	N
ыңғай	A
аңғару	V
сана	N
бұғау	N
жаяу-жалпы	N
бақырауық	A
былайғы	ADV
ағызатын	A
асып-сасу	V
сүттей	A
робот	N
күнгей	N
күпілдеу	V
хақ	N
мәжіліс	N
арқардай	A
президент	N
ұшықтау	V
бедеу	A
өзге	PRO
мүмкіншілік	N
қоңылтақсу	V
шұлғу	V
әуелгіде	ADV
эпиграф	N
тілектес	A
баспалдақ	N
шамалас	A
ұят	N
еркелік	N
әңгімешіл	N
өміршеңдік	N
естіп-білу	V
мен	PRO
жүген	N
борпылдақ	A
тойтару	V
діңгек	N
ғылыми	A
қабыстыру	V
интеллигент	N
былдырлау	V
боқтампаз	N
ақылдасу	V
арландай	N
қағылез	A
қаншама	ADV
оқымаған	A
гонорар	N
үндемеу	V
боқ	N
шатырлау	V
кездеу	V
тәрбиелеу	V
ынталану	V
сұр	A
сілекейлеу	V
Әзімжан	N
сұр	N
солғұрлым	ADV
министрлік	N
бейсенбі	N
шынар	N
көкірекше	N
құрдас	N
терезе	N
халиф	N
өсиет	N
бестік	NUM
кеміту	V
үзеңгі	N
бәрі	PRO
тиімділік	N
жырту	V
үміттену	V
ойландыратын	A
көне	A
тоқшылық	N
үстіңгі	A
кескі	N
көретін	A
көкқасқа	N
керуенші	N
жаттау	V
ойлы-қырлы	A
парта	N
дипломатия	N
сызғылау	V
зеріктіру	V
жіңішке	A
көлеңке	A
Шынаржан	N
россия	N
қызығушылық	N
мақұл	ADV
вена	N
қиғаштау	V
азан	N
долбар	N
асығып-үсігіп	ADV
кезектесу	V
сөре	N
айтарлықтай	A
таяқша	N
Айбақ	N
айырбастау	V
конвенция	N
қобызшы	N
тау	N
күйме	N
алжасу	V
қозы	N
өрт	N
қайсарлану	V
жалынышты	A
май	N
оқталу	V
кадр	N
байлаулы	A
жент	N
даралық	N
апта	N
жымыңдау	V
неке	N
айғақтау	V
нағашы	N
аш-арық	A
қожалық	N
айғыр	N
ұдайы	ADV
нато	N
ауз	N
қаулау	V
тұтынушы	N
ұйқы	N
сүтқоректілер	N
кандидаттық	A
қарайлау	V
өздігінен	ADV
жынданды	V
қомағайлық	N
тиын-тебен	N
сапарлас	N
рапорт	N
қалқажан	N
алмалы	A
экспедиция	N
қатқыл	N
егіншілік	N
семірген	A
Шайх-Хайдар	N
кітапша	N
жазира	A
қалғу	V
Абай	N
тасу	V
жұпар	N
жаулау	V
сезгіштік	N
ереже	N
ауырсыну	V
лақтыру	V
ендеу	V
көтермелеу	V
үстірт	N
еріншектік	N
жұққан	A
өлмейтіндік	N
асфальттау	V
талап-тілек	N
сан	N
схема	N
тұрпайылық	N
сәлемхат	N
салмақтау	V
ұштастыру	V
құрбан	N
намыстану	V
игеру	V
дыбырлау	V
құлама	N
шаптығу	V
үрку	V
жалтаң	A
қиқарлану	V
аузы-мұрны	N
сопрано	N
сылаң	N
қояншық	A
зырылдау	V
ен-таңба	N
мыжу	V
жөнде	N
теңесу	V
сөзшең	A
ауытқушылық	N
жинақ	N
шынылау	V
бек	N
алмастай	A
тоқыма	A
дауыс	N
асау	A
Ұлықбеков	N
күнбағар	N
жорамалдау	V
үңгір	N
шапшу	V
шығыршық	N
бітіспес	A
қолжазба	N
шым	N
таңырқау	V
көлеңкеленген	A
теледидар	N
адамзат	N
жүлде	N
пікірталас	N
шідер	N
тізу	V
қайын-жұрт	N
Қармысов	N
несие	N
өргізу	V
нәсілдес	A
нықтау	V
ертегі	N
ашқарақ	A
көпіршік	N
тұрғызу	V
аурушаң	A
шешкізу	V
аңшылық	N
бағана	N
үшеу	NUM
өшігу	V
жігер	N
ерке	A
оймақтай	A
көже	N
сауап	N
финал	N
жоғарғы	ADV
Көтеш	N
үлес	N
сіңбіру	V
кесектеу	V
оғаштық	N
кептірген	A
бәйбіше	N
кісенделу	V
шабуылдайтын	A
сектор	N
сенімхат	N
мүшелеу	V
құшақ	N
дұшпан	N
алаудай	N
мөлию	V
лауазым	N
беку	V
биік	A
шақырушы	A
нашақор	N
шөп-шалам	N
бір-бірімізді	PRO
ұру	V
төртінші	NUM
үстеу	N
сырлас	A
Қожық	N
үстеу	V
жабу	V
саулау	V
еңсеру	V
даяр	A
амал	N
Қытай	N
қор	N
сарылық	N
баяу	A
баланс	N
цикл	N
періште	N
тәжік	N
өлекшін	N
бальзамдау	V
Ясауи	N
ата	N
үдемелі	A
факультет	N
тұмылдырық	N
белшеден	ADV
фашист	N
қырсығу	V
тілік	N
тіреу	V
қарама-қарсылық	N
қуқыл	A
шырмалған	A
қақыру	V
мызғу	V
феодал	N
Шайбани	N
әжет	N
буландыру	V
есім	N
Маңғыстау	N
аласапыран	N
кешеуілдеу	V
балаша	N
зерлі	A
жазмыш	N
төндіру	V
шанышқы	N
коммунизм	N
көрегендік	N
көресі	N
жолдастық	N
халифат	N
дүдәмалдану	V
сөйлемейтін	A
оқиға	N
жайшылық	N
бөле	N
рулық	N
қуалау	V
оспадар	A
айттырылу	V
семген	A
доғару	V
бару	V
дызылдау	V
шытыр	N
дәрігер	N
піспек	N
киностудия	N
азсыну	V
тақсірет	N
жырт	N
италия	N
есінеу	V
күміс	N
курс	N
қылшықтау	V
буат	N
кілт	N
культура	N
ұнтақ	N
балдырған	N
нәсіл	N
тұрғызылу	V
бастыру	V
өріс	N
қиян	A
жағалтай	N
ауданаралық	A
ой-өріс	N
қаракөз	A
әзірлену	V
дереу	ADV
Тамам	N
былай	ADV
қырлы	A
оқпан	N
әділеттік	N
тыпырлау	V
тотығу	N
қараушы	N
тарс-тұрс	IW
жарғанат	N
ұқыпсыз	A
бекітілу	V
ұйғару	V
әуелі	ADV
ракета	N
қауқар	N
нанғысыз	A
мәрттік	N
қиқаңдау	V
касса	N
шабындық	N
қанішер	N
құлып	N
динамика	N
геосаясат	N
шөкім	N
жылан	N
бұт	N
биылғы	ADV
Халін	N
өтірік	A
қарар	N
тырмысу	V
алда	ADV
бірлі-жарым	A
дегендей	CONJ
консультация	N
кергіш	N
бұйралау	V
бас	A
әңгі	N
нақыштау	V
сыйлас	N
үзбей	ADV
қайырымсыздық	N
самұрық	N
көкпар	N
абалау	V
қорғансыздық	N
тақылдау	V
Жолдасбек	N
татуласу	V
иіс	A
шымылдық	N
балапандау	V
сән	N
зақым	N
спирт	N
зорығу	V
зымырау	V
сарылдау	V
қапы	ADV
айғақ	N
дамушылық	N
астаналық	A
жеңілдету	V
қарпу	V
бразилиялық	N
арнайы	A
алғырлық	N
сушы	N
Бақтықожа	N
халықаралық	A
билеуші	N
күмбір	N
аяу	V
ұйғарым	N
қажеттілік	N
сүмеңдеу	V
оқытушы	N
жағал	A
терроризм	N
кеден	N
құлаштап	ADV
шарап	N
жылтылдау	V
қытырлау	V
құдайы	N
сурет	N
қанағаттанарлық	A
үгіттеу	V
очерк	N
салалау	V
кему	V
олқысыну	V
кірбию	V
саңылау	N
куәлік	N
соғыс	N
алпысыншы	NUM
арматура	N
сүлгі	N
романтикалық	A
корпорация	N
психологиялық	A
жазықтық	N
аудандау	V
тереңдеу	V
монополист	N
ұйқас	N
апай	N
меморандум	N
шекарашы	N
ереуіл	N
себелеу	V
март	N
әдеп	N
тәлім-тәрбие	N
ернеу	N
сері	N
теңбе-теңдік	N
Барат	N
мұнайшы	N
аңқу	V
жоюшы	N
шабуыл	N
адыраю	V
сонау	PRO
делегация	N
ақкөңіл	A
есуастану	V
орфография	N
жакындау	V
үкім	N
әзілдеу	V
мақтаншақтық	N
бейпіл	A
үстел	N
мекемелік	A
балық	A
айырылғандай	N
таным	N
әсерлілік	N
келіссөз	N
қуыру	V
сырма	A
бөбек	N
бақылдасу	V
адамдай	ADV
даңғыл	N
отаршы	N
аман-саулық	N
қу	N
қу	A
орамал	N
сымбаттылық	N
аралық	N
максимум	N
думан	N
қысыңқырау	V
қынжыла	N
қирау	V
бум	N
қатынаспау	V
қарсылық	N
жабырқау	V
көмей	N
әжуа	N
еркінше	ADV
қонақ	N
білгіштік	N
спектр	N
йод	N
күшіктеу	V
іштей	ADV
жастық	N
қымбатшылық	N
қорап	N
гуілдеу	V
перспектива	N
шешілу	V
фактура	N
ақыл-ой	N
үйретуші	N
қарасөз	N
күймейтін	A
фарс	N
оқты	A
септік	N
ширау	V
тіркелген	A
контекст	N
апалық	N
австралия	N
тығу	V
бұұ	N
жіптіктей	A
құлын	N
тізбектелген	A
бауырласу	V
жарқыл	N
дос-жар	N
жанашыр	A
ақиық	N
тұстас	N
ишарат	N
аяқ-табақ	N
қабу	V
шақша	N
дүрсілдеу	V
жорықшы	N
тынбастан	N
төрлету	V
пәк	A
декан	N
күбірлеу	V
қайысу	V
мәпелеу	V
Зейнолла	N
бақылаушы	N
Тәңірберген	N
биші	N
қатысушы	A
арлану	V
қораш	A
көпей	N
кейіп	N
қазы	N
желетке	N
райлану	V
мал-жан	N
көсілу	V
жемшөп	N
зейін	N
күйзеліс	N
аңду	V
сиыну	V
көр	A
заулату	V
көр	N
болғар	N
зығыр	N
шолтаң	A
шөпілдету	V
сенбі	N
ауырады	V
алтайлық	N
дарындылық	N
славян	N
басқа	A
торлы	A
тұрақталу	V
экспонат	N
бірігу	V
электрон	N
коллекция	N
ойнас	N
мақау	A
кезерген	A
Алатау	N
айдын	N
ойшыл	A
құқықтық	A
жауырын	N
қармақ	N
алдырмау	V
шабан	A
айнала	N
интуиция	N
найзағай	N
шиша	N
коллегия	N
жасаурау	V
моншақ	N
массаж	N
тәкаппарлық	N
шалдыққан	A
диагноз	N
кір	A
әмірлі	A
таңдамалы	A
жаздық	A
бітуі	N
шиыршықтау	V
басылу	V
нөмір	N
белес	N
курьер	N
аз-маз	N
қажылық	N
зиялы	A
Чжао	N
өкпелеу	V
қалақша	N
өкім	N
Уайс	N
кеш	N
порт	N
астана	N
омырылу	V
қалашық	N
тізелеу	V
жақындағы	A
түңілген	A
қоза	N
дария	N
сыбдыр	N
мина	N
мұжық	N
азғантай	A
киімшең	A
құлау	V
сыра	N
сертификат	N
түкпір	N
пышақтау	V
дүрілдеу	V
домалау	V
Кенжекей	N
конкурс	N
эпидемия	N
барымта	N
сыналау	V
сиқыршы	N
қамдау	V
жоламау	V
талпыныс	N
шектеу	V
бәсекелес	N
көңілді	A
кинофестиваль	N
өндіршек	N
ескертетін	A
аспаптық	A
Моғолстан	N
қудалау	V
байқалған	A
аралату	V
кезек	N
сатушы	N
никель	N
құптау	V
әліпби	N
сондай	A
келе-келе	ADV
сонша	ADV
қуыршақ	N
қазықтау	V
интеллектуалды	A
шыдамдылық	N
жайлану	V
ая	N
түсік	N
аялау	V
теңге	N
бозбала	N
қақпа	N
қай	A
шебер	A
аңсар	N
шебер	N
тұрғын	N
бөрібасар	N
жамылғы	N
қорым	N
жадағай	N
ыдыс	N
қиянат	N
балтырлы	A
салқындық	N
сандық	A
қамшы	N
уәзір	N
бұлшық	N
судырау	V
жылау	V
жеңеше	N
планшет	N
желек	N
өтемақы	N
қарбалас	N
көктемгі	A
жүректілік	N
сүю	V
билет	N
жілік	N
бекет	N
камшат	N
тат	N
өр	N
иба	N
гипноз	N
генерал-майор	N
сытыр	IW
тебу	V
жымқыру	V
телеграмма	N
бөліс	N
сапалы	A
тәуір	ADV
бауыздау	V
әлсіреу	V
серпілу	V
емтихан	N
өндіруші	N
жаңалық	N
бұртию	V
Цеван-доржи	N
жазғытұрымғы	A
безеңдеу	V
жатақхана	N
аяқастынан	ADV
бұлғаң	A
сөз	N
астарлы	A
аржақ	N
парадигма	N
япырай	INTJ
әл-ауқат	N
Хадиша	N
бұлтартпау	V
бірыңғай	A
аталық	N
ажарландыру	V
жолаушы	N
кестелі	A
шеңгелдеп	ADV
аспап	N
жауын-шашын	N
ізгілік	N
төңірегінде	N
тұтқырлану	V
жота	N
Сайбан	N
Жаһанкүл	N
салым	N
кәсіпкерлік	A
жекеше	ADV
кәсіпкерлік	N
арқандаулы	N
бажыл	N
посылка	N
балталау	V
себебімен	POST
дәм	N
айыққан	A
берегірек	ADV
кигізу	V
өңкей	N
сұмпайы	A
еркіндеу	V
Жошы	N
диктант	N
сатиралық	A
бәле	N
ұсыныс	N
үлестіру	V
наган	N
оңған	A
қайыр	N
аяздау	V
Сырдария	N
идеялық	A
зәру	N
борау	V
энергетика	N
Ерлан	N
асулы	A
қарсылас	N
дарылдау	V
Татьяна	N
шақ-шұқ	IW
бұзау	N
тонаушы	N
өзінікі	A
ванна	N
тырнақша	N
милиция	N
зорлану	V
күю	V
жуандық	N
артта	ADV
туынды	N
шылпылдау	V
шала-пұла	ADV
тоңазытқыш	N
жәрдем	N
кетпен	N
тору	V
жоба	N
король	N
Майқы	N
бұлтылдау	V
Ұмбетәлі	N
ырсию	V
ғасырлық	A
сүмбі	N
еріткіш	N
кеңесші	N
барометр	N
жатыр	N
аулақ	A
зілдену	V
қоғам	N
жадап-жүдеу	V
норматив	N
бизнесмен	N
апа	N
көгал	N
сығалау	V
сабантой	N
методика	N
санитар	N
атсалысу	V
заряд	N
ұлар	N
Удай	N
бірлесу	V
тұратын	A
сейілту	V
бөрене	N
туғалы	N
әріп	N
соғысу	V
шапшаңдату	V
бөлу	V
енгізу	V
аға	N
тосу	V
қыран	A
жымиысу	V
қыран	N
әуелде	ADV
үңірею	V
алыстық	N
и	CONJ
таңертеңгі	A
жоқшылық	N
ақырзаман	N
өктемдік	N
вертолет	N
әкелі-балалы	N
ох	INTJ
айуандық	A
кәлима	N
таңданарлық	A
албырату	V
қатық	N
ария	N
жегу	V
ұрықтану	V
шатынау	V
реттеуші	A
қола	N
тіршілік	N
қасаң	N
қола	A
арқалану	V
пенсия	N
қомсыну	V
ұйытқы	N
теңгелік	A
ғақлиялық	A
қоздырушы	N
дикция	N
Асан	N
арманшыл	A
аяқ	N
шілтер	N
үндіс	N
күнілгері	N
шайнасу	V
жеңдік	N
құлан	N
жарайды	INTJ
шоқу	V
единица	N
жасөспірім	N
ешқашан	PRO
шағыну	V
қаршадай	A
тиым	N
ардақ	N
обком	N
ұлғаю	V
істеу	V
аударма	N
төбе	N
төбет	N
Айболат	N
хатшылық	N
өлімтік	N
жудыру	V
пешене	N
режиссура	N
талас-тартыс	N
азынау	V
анайы	A
жылға	N
Назарбаев	N
абақ	N
маң	N
талау	V
шабандоз	N
арпа	N
қарындас	N
зауыт	N
этикалық	A
ағыс	N
итаршылық	N
токсин	N
күншуақ	N
үсу	V
таға	N
іздеу	V
этнография	N
дабыр	N
дембелше	A
әттегене-ай	INTJ
шапалақтау	V
төскей	N
сөйту	V
тәртіптілік	N
пайда	N
ақылшы	N
қулану	V
диспетчер	N
қастерлі	A
Ұлыбритания	N
ектіру	V
қамыт	N
Сәбит	N
астан-кестен	N
табалау	V
сәйкестілік	N
өйткені	CONJ
сыртылдау	V
қолғап	N
волейбол	N
арланбау	V
түзету	N
сайрау	V
масқарашылық	N
даулау	V
түзету	V
фермент	N
қорғаныс	N
сүрме	N
қаңырау	V
түйіршік	N
зарлы	A
оқырман	N
ой-пікір	N
тұңғиық	N
күйрету	V
тенор	N
шаңқыл	N
тұңғиық	A
ыстау	V
игі	A
жаңсақ	A
құдағи	N
үштік	N
қарау	V
тұншықтырғыш	A
сандалу	V
абақты	N
талтаю	V
декларация	N
сенбеу	V
мұнара	N
былығу	V
мәселе	N
құнарлы	A
көпше	N
білім	N
ауық-ауық	ADV
американдық	N
түкіру	V
қорғау	V
Едіге	N
үшкір	A
босату	V
қиын-қыстау	A
қайым	N
ғарыш	N
жалтырау	V
шеке	N
басымдық	N
айрылу	V
былқылдау	V
аттестат	N
масақ	N
қиқулау	V
тізе	N
қораз	N
тербету	V
даңқ	N
марокколық	N
Айгүл	N
бейнеттену	V
бірақ	CONJ
ризашылық	N
сылқым	N
екпін	N
осқыру	V
ұялау	V
отау	N
ұйымшыл	A
айналақтау	V
қашықтық	N
лағнет	N
тұяқ	N
кәмелет	N
алу	V
шылым	N
мастық	N
быжу	V
арша	N
есен	A
казактар	N
әдіс	N
тұлып	N
атаман	N
арман	N
қатынасу	V
технологиялық	A
ақсақ	A
дем	N
бақан	N
баяғыдан	ADV
қайыршы	N
үндеме	N
қауіп-қатер	N
мұнай	N
ұзау	V
олар	PRO
көркейту	V
Сирия	N
шиелену	V
сатқын	N
асылдану	V
абажадай	A
жеңге	N
жұп-жұмыр	A
үйіру	N
ерлі-байлы	N
болт	N
жұмбақ	N
парторг	N
тырсию	V
жәйлі	A
тарату	V
жөндету	V
бекіну	V
сойқанды	A
бөксе	N
банкі	N
қыпылдау	V
әрі	ADV
қоштасу	V
іңір	N
егемендік	N
тәуліктік	A
трамплин	N
пайдаланушы	N
мазар	N
сыйысу	V
өру	V
бұлғын	N
пистолет	N
тоқтату	V
артикль	N
мақал	N
жай	N
тартушы	A
қағазбастылық	N
өзгеру	V
дақыл	N
күйреген	A
шуылдақ	N
зайып	N
асылдық	N
қамаулы	A
ұсақталу	V
көрсетуші	A
бейбітшіл	A
аралығындағы	ADV
жусату	V
мүкіс	N
Уәлиханов	N
блокнот	N
тістесу	V
ойранды	A
айуандықпен	A
дестелеу	V
сыну	V
бүгілу	V
тергеуші	N
есімше	N
қамқор	A
айтақ	N
коммюнике	N
асыранды	A
әдептілік	N
ебедейсіздік	N
тіктеу	V
Бұқар	N
шарапат	N
шекпен	N
мұңайып	ADV
Сейсен	N
желеу	N
жылауық	A
оқымысты	A
алуа	N
оқымысты	N
адал	A
премьера	N
доп	N
ойнақылық	N
суу	V
жеке-жеке	A
рай	N
туған-туыс	N
радиация	N
қарамау	V
Ермахан	N
талқылау	V
жару	V
саумал	N
сеңсең	N
әдейі	ADV
шірену	V
алаңдау	V
зиян	N
шапшаңдық	N
контакт	N
табыскер	N
қалмау	V
күрсіну	V
астау	N
кешірім	N
торлану	V
алда-жалда	ADV
нәсіп	N
солу	V
жалқау	A
кей-кейде	ADV
сүйген	A
тон	N
күріш	N
қоңыз	N
сифилис	N
ұстаз	N
жұлдырту	V
мана	ADV
ысқырық	N
өңді	A
кілттеу	V
вагон	N
қашықтау	V
жамаулы	A
таршылық	N
қорған	N
армения	N
ғасыр	N
қажу	V
суырма	N
бейқамдық	N
латвия	N
жауылша	N
ереуілдеу	V
ливиялық	N
бозғылт	A
шортан	N
татулық	N
бәрекелді	INTJ
сарқыт	N
прожектор	N
қостау	V
кішірейту	V
Созақ	N
гүмпілдеу	V
Дьяков	N
шағындау	V
сегмент	N
мағыналас	A
арыстанша	ADV
қапас	N
қаракөл	N
сақаулану	V
жату	V
езгілеу	V
Гумилев	N
түлету	V
сүзеген	A
тиімсіз	A
бұғу	V
орда	N
мардымсу	V
символизм	N
барлық	ADV
сұрастыру	V
ұстаздық	N
шабынды	N
өліара	N
теке	N
бақсы	N
сүйірлену	V
әне	PRO
серия	N
бәсекелестік	N
цензура	N
жарық	N
жіктеу	V
округ	N
Қоңыртөбе	N
сәндік	A
айна	N
бүйірлеу	V
қырықбуын	N
қолдаушы	N
болдырмау	V
балпылдау	V
көмірсутек	N
жаптыру	V
әупірім	ADV
депутаттық	A
жаңағы	ADV
әулет	N
зада	A
үрпиісу	V
бітіру	V
дәме	N
сызық	A
түпнұсқа	N
колонна	N
мифология	N
Ісләм	N
пәндік	A
пионер	N
шүңірек	A
қуана	ADV
береке	N
шабуылдау	V
шапқылау	V
арамтамақ	N
шығармашылық	A
шығармашылық	N
бозторғай	N
коллектившілдік	N
жұп-жуан	A
оюлы	A
кебек	N
шимайлау	V
күнә	N
поэма	N
жөнделу	V
аусыл	N
хауыз	N
арамзалық	N
өршелену	V
апан	N
ауызбірлік	N
шыт	N
сезім	N
жиналу	V
кісі	N
туралау	V
ас	N
бүлдірген	N
көру	V
ағаш	N
сұрқия	N
қадағалау	V
үндес	A
расында	ADV
жеміс	N
жуасу	V
сен	PRO
танкетка	N
қоныш	N
отыз	NUM
Семей	N
қаусыру	V
көпіретін	A
жөтел	N
миллион	N
кокаин	N
күйіс	N
серпін	N
жосық	N
бармақтай	A
еді	V
тәлкек	N
бидайық	N
кіре	N
қайғыру	V
безеулі	A
қайтпайтын	A
кәрі	A
әрлеу	V
қамба	N
таяқ	A
баулу	V
астам	ADV
қанағаттанушылық	N
тоқпақ	N
зорайту	V
ошақ	N
белорус	N
көлгірсу	V
әуреленбеу	V
аңшы	N
тобылғы	N
аулау	V
еңкілдеу	V
ақыл-кеңес	N
түгелдеу	V
еңбекшілдік	N
құбылу	V
қорқу	V
қағілездік	N
интернационал	N
он	NUM
артистік	A
нұрлы	A
ибалы	A
тоқталу	V
қырқа	N
тартпа	N
байытылу	V
шерту	V
изесу	V
иінағаш	N
кілем	N
ұсыну	V
сәт	N
бетон	N
кеше	N
пітір	N
анау	PRO
проблема	N
жорушы	N
публицистика	N
жұптау	V
төзімділік	N
мүсінші	N
арзандау	V
аты-жөні	N
даугер	N
ебелек	N
әбестік	N
қылыштасу	V
түсіндірмелі	A
кескілеу	V
танымдылық	N
христиан	N
шымыр	A
генерал-полковник	N
кәзіргі	A
көріктілік	N
күпсу	V
ұшан-теңіз	A
сәукеле	N
бытыра	N
ұзату	V
Мұратбек	N
купе	N
айту	V
тыныстау	V
өтеу	V
бірлік	N
өнімділік	N
сенсация	N
увертюра	N
білгір	A
Қасымжан	N
байқағыш	A
хабаршы	N
сыбайлас	N
алушы	N
кінә	N
мүсіндеу	V
жантық	N
омарта	N
маңдайша	N
өту	V
аққұба	A
көбейту	V
спонтанды	A
Сорокин	N
немере-шөбере	N
ашқарақтану	V
монография	N
ғимарат	N
саялау	V
салма	N
жеткізу	V
семіру	V
қайта-қайта	N
ресторан	N
жаңылу	V
Жақып	N
бекерден-бекер	ADV
сектанттық	N
тәуелсіздік	N
байтал	N
Бекболат	N
қарамық	N
жеңімпаз	N
ақсату	V
еңбекқорлық	N
қақталған	A
боз	N
бірлестік	N
елгезектік	N
сөлекет	A
сөмке	N
серттесу	V
Бекбосынов	N
мата	N
әлемдік	A
музыка	N
іспеттес	A
жарылғыш	A
іріту	V
жалқаулық	N
басым	A
арзан	A
жарыс	N
ырылдау	V
ызғар	N
қағу	V
дабырлау	V
дардай	A
ағайын-тума	N
қызғылықты	A
кеңсірік	N
бұлқыну	V
Бишара	N
кейінгі	A
мәз-мәйрам	A
мидай	A
сору	V
жағажай	N
гипотеза	N
мүжу	V
алысу	V
кедейшілік	N
жатақ	N
бастапқы	A
бүтінделу	V
бейдауа	N
керектік	N
сытырлау	V
бөріту	V
шошқа	N
күйреу	V
жұмсақтық	N
қабырғалы	A
жарқын	A
өшіру	V
жаутаңдау	V
көңілдену	V
камера	N
созылыңқы	A
ығын	N
ұлпалану	V
үндестік	N
ерлену	V
тұсалу	V
қозу	V
қапсыру	V
мән-жай	N
ордалы	N
бусану	V
сөйлеу	V
тізбек	N
Әуелбек	N
секпіл	N
сүзек	N
кириллица	N
мылжалау	V
майдалау	V
көкпек	N
бүйір	N
тегі	PARENTH
қағылу	V
есейген	A
тұтасымен	ADV
алым-салық	N
сою	V
атлет	N
қорықшы	N
арбайтын	A
піштіру	V
салат	N
күндейтін	N
ынтығу	V
шай	A
алқап	N
қияр	N
мұндағы	PRO
рынок	N
құндылық	N
әрине	PARENTH
иықтау	V
аспандау	V
күрескер	N
қалаш	N
сайман	N
реттелу	V
зоотехник	N
шынжыр	N
көлем	N
капитал	N
Шымкент	N
көршілік	N
түсу	N
алаңдатарлық	A
иіскелеу	V
кәндек	A
борбайлау	V
қымқыру	V
жаға	N
өркеш-өркеш	A
әйнек	N
түсу	V
бөгелу	V
шалажансар	A
Сақила	N
физика	N
кен	N
мүшел	N
жетім-жесір	N
тігінші	N
бұратана	A
қайыру	V
тазарту	V
конверт	N
зәре	N
жым-жылас	N
айырушы	N
ынтықтық	N
католик	N
абзалы	A
тоқты	N
ұшық	N
қалайша	PRO
ертекші	N
дірдектеу	V
оптикалық	A
өрмекші	A
өрістеу	V
әлсін-әлсін	ADV
Қаптағай	N
жемқор	A
қабыр	N
сауық-сайран	N
терек	N
күйгізу	V
көкөніс	N
аяздай	A
Қырғызстан	N
келін	N
қамтамасыздандыру	N
кәміл	A
бейнелеу	V
бундестаг	N
Жұмабек	N
мөр	N
құлақшын	N
дозақ	N
алакөлеңке	N
Орынбор	N
сыңаржақ	A
сый-құрмет	N
тойдыру	V
көтеріңкі	A
сондыктан	PRO
мықтап	ADV
ұйымдастырушы	N
қуыс	N
эксперимент	N
қимас	A
жаз	N
шаршағандық	N
тұйықтау	V
аңырату	V
дүрбі	N
жаугершілік	N
құлындау	V
нөсер	N
жекеменшік	N
жындыхана	N
сыпсың	N
өзгерек	ADV
жалтырақ	A
дөңбекшу	V
үміт	N
кассир	N
шайқау	V
нашарлық	N
найзаласу	V
әйгілеу	V
ілбу	V
олжалы	A
салу	V
Шақшақ	N
күтірлету	V
қару	N
тақпақтау	V
өркеш	N
жаза	N
жасылдану	V
бейіт	N
қызару	V
ғана	CONJ
кеңсе	N
поляк	N
оңалу	V
шеген	N
қос	A
таялу	V
экспорт	N
автореферат	N
хал	N
жағымды	A
атырап	N
теориялық	A
құлдырау	V
портфель	N
жандарм	N
жамбастау	V
құмар	N
бүге	N
қақаңдау	V
жанр	N
Тыр	N
тұжыру	V
сақтаушы	N
фонарь	N
желу	V
наз	N
ғылым	N
тағдырлас	N
Башар	N
безек	N
жауапкер	A
вахтер	N
аттап	ADV
орама	N
сайқал	N
міңгірлеу	V
отставка	N
жону	V
дағдылы	A
кибернетика	N
Рошаль	N
шыңғыру	V
ұю	V
салшы	N
жарлық	N
мысқыл	N
кептер	N
саздау	A
бүліншілік	N
көнеру	V
қашыр	N
қапырық	A
ақжал	A
қапырық	N
сырғу	V
елтану	N
инфекция	N
көңілдендіру	V
айқындауыш	N
сілті	N
сөгу	V
күйе	N
тулау	V
жауынгер	N
жарыссөз	N
құйындай	ADV
еуропа	N
боз	A
математика	N
түсім	N
артықшылық	N
үнемдеу	V
ұжым	N
консулдық	N
ем	N
желкелеу	V
мелшию	V
протокол	N
оқшантай	N
отар	N
көмескі	A
Сырымбет	N
актерлік	A
индустрия	N
дән	N
әркім	PRO
тұнба	N
өтіс	N
қажығандық	N
қуаттау	V
тоқал	N
жусан	N
бала	N
тақылеттес	A
қоралау	V
кескіндеме	N
асхана	N
жарықтық	A
рентген	N
майлы	A
құрғақ	A
қосалқы	A
кәсіптік-техникалық	A
жетінші	NUM
бастамашы	N
шел	N
құрғақ	N
таба	N
тұздау	V
жерлестік	N
дәу	A
кекшілдік	N
баяғыда	ADV
Қазыбек	N
есею	V
жазылым	N
ханым	N
қану	V
хром	N
қасап	N
тебен	N
Ырымбек	N
арпалыс	N
тұйықтану	V
аздап	ADV
сезіктену	V
мойындау	V
қаратамақ	N
жем	N
сүрлеу	V
ашылу	V
әйел	N
сәуле	N
ұрлық	N
ізет	N
тұйықталу	V
сүйрелеу	V
аралау	V
бықсу	V
сорғалау	V
анайылық	N
жұп	A
мықыр	A
идиома	N
паразит	N
бұрын-сонды	ADV
кектену	V
неміс	N
ата-баба	N
қыл	A
туған-туысқандар	N
айтыскер	N
соқыр	A
құлантаза	N
ызақор	A
қорытындылаушы	A
боқмұрын	N
қарахандық	N
арба	N
болаттай	A
молаю	V
өндіріс	N
көрмес	N
шелектеу	V
алабота	N
кешіру	V
мүше	N
рекомендация	N
мазут	N
көтермеу	V
уыс	N
Еуразия	N
көп	A
жасақ	N
кілегей	N
отырыс	N
сескену	V
тасымалдау	V
өткінші	A
қатыгез	A
брезент	N
сұрыптау	V
мін	N
ырың-жырың	N
бүткіл	PRO
егеменді	A
қына	N
Сайрам	N
тарпу	V
эмоциялық	A
шақ	N
шынығу	V
аласы	N
Хорезм	N
кірбің	N
аңқау	A
телекөпір	N
классификатор	N
австрия	N
едәуір	ADV
бейнелену	V
өңге	A
жұту	V
қырат	N
таспалы	A
тырма	N
бар	A
офицер	N
шыңырау	N
құлжа	N
кәззап	N
ыңғайлылық	N
түсінушілік	N
көшет	N
магний	N
тірек	N
буфет	N
еркелеу	V
тозу	V
тізбелеу	V
ұланғайыр	A
тұншықтыру	V
түйір	N
әуез	N
автоматтандыру	N
қайырма	N
дәнігу	V
бастан-аяқ	ADV
ертең	ADV
әділет	A
мүдделі	A
мықшию	V
клуб	N
Өскемен	N
аймақаралық	A
жансыздық	N
аялы	A
кездесу	V
иелену	V
тайғанақ	A
ілесу	V
қаһармандық	N
күмбез	N
да	CONJ
шағыл	N
білдіру	V
рақат	N
жұтау	V
қатысу	V
ымыра	N
көрші-қолаң	N
кеңінен	ADV
төкпе	N
шарбақ	N
қаріп	N
әлеумет	N
мәнер	N
мердігер	A
тұздалу	V
боталау	V
қошақан	N
алмау	V
автокөлік	N
адымдап	N
сахара	N
тарқау	V
әл	N
жаңаша	ADV
котелок	N
қолхат	N
аспирантура	N
дума	N
үйірме	N
елтаңба	N
фигура	N
қоқыс	N
тиелген	A
қаншық	N
шілік	N
желін	N
боза	N
Шалғынбаев	N
тұз	N
ұйтқу	V
қақаю	V
әріде	ADV
көрініс	N
термостат	N
шаю	V
шұрқырау	V
не	CONJ
асқақтау	V
кенші	A
олжалау	V
толмау	N
бейғам	A
Чернов	N
барынша	ADV
босану	V
апыр-жапыр	N
теп-тегіс	A
коэффициент	N
секретарь	N
сұғанақ	A
ырғау	V
Бұзахұр	N
қайран	N
қанттау	V
плащ	N
майлау	V
қылжақ	A
қарасан	N
жүзінші	N
төгілу	V
күлдіргі	A
қаралу	V
өкпелі	A
өлу	V
қырсық	N
банды	N
абыржу	V
тақым	N
аталым	N
қақылдау	V
парк	N
күлдік	N
пирамида	N
бірлесе	ADV
кемпір	N
қолданыс	N
атаулы	ADV
серіктестік	N
орағыту	V
кейін	ADV
кездейсоқтық	N
өлке	N
Тобыл	N
азды-көпті	N
мақтаулы	A
зауал	N
көш	N
жабық	A
дүрлігу	V
шалғы	N
тоқтатпай	ADV
фельдшер	N
сараңдану	V
үлгілі	A
романс	N
ауадай	A
жағымпаз	A
алай-дүлей	N
қабы	N
небір	PRO
қам	N
таңба	N
анар	N
бөлену	V
әсерлеу	V
интернат	N
Қасен	N
шұрылдау	V
қалбағай	N
шегі	N
сирақ	N
аждаһадай	N
пима	N
алды-арты	ADV
дағарадай	A
сыртқары	ADV
итмұрын	N
гулеу	V
ажыратпай	ADV
ит	N
тәулік	N
Потебня	N
сұраныс	N
жанасу	V
жауыз	A
қарайту	V
түп	N
кемеңгерлік	N
сәбіз	N
жар	N
түсініктеме	N
жүргінші	N
ата-ене	N
фермер	N
сәуір	N
факт	N
жүргінші	A
совхоз	N
диалог	N
қайтпау	V
іркілместен	ADV
жоқтық	N
елдік	N
украин	N
Манас	N
ағайын-туған	N
маңғаз	A
Айтолқын	N
музей	N
бағыттау	V
суқойма	N
шайыр	N
Бөгенбай	N
ақсақал	N
байпаңдау	V
шегіншектеу	V
Абдолла	N
почташы	N
шұңқыр	N
сауыншы	N
тас	N
кем	A
нерв	N
яғни	CONJ
қарқылдау	V
ілгек	N
делеңдеу	V
жетімсіздік	N
жоса	N
тырмалау	V
жарғыш	N
Жәмішев	N
педиатрия	N
қодас	N
оба	N
қашқақтау	V
шашбау	N
ерсі	A
адырна	N
пәлен	A
оспақтау	V
бір-бірлеп	ADV
ажал	N
егде	A
лажсыздан	ADV
ілігу	V
аттай	ADV
үлпілдеу	V
саябыр	N
уыстау	V
уәделесу	V
тер	N
жарамдылық	N
қарама-қарсы	A
өгей	A
атандай	A
талшық	N
сілею	V
көршілес	A
қарасу	N
актуалды	A
ойылу	V
ірі	A
курсант	N
ұятсыз	A
азғыру	V
жерлесу	V
делбе	N
авторлық	A
есуас	A
сегізінші	NUM
даукес	N
макарон	N
ұжмақ	N
қырылысу	V
мылқау	A
Ақторғын	N
болжау	V
сыйлық	N
дидарласу	V
шілдехана	N
сүйеніш	N
доктор	N
жуыту	V
мыс	N
патшалық	N
түнерген	A
топалаң	N
сөк	N
демеуші	N
аула	N
киіну	V
ақсақ-тоқсақ	A
рух	N
наркескен	N
ән-күй	N
Жаниша	N
жымиту	V
тарту	V
ұйқылы	A
шарасыздық	N
қаспақ	N
ұзақ	N
итқонақ	N
жылдам	A
ұзақ	A
шымшу	V
уайым	N
Анархай	N
еңбекқор	N
әуен	N
қауын	N
ассалаумағалейкүм	INTJ
қылаңдау	V
жору	V
құмтас	N
меңзеу	V
сояу	N
қатаң	A
жәбірлеу	V
сырғанақ	A
ап-айқын	A
өйтіп-бүйтіп	ADV
пластикалық	A
жәбір	N
құдаша	N
ниетті	N
сүйісу	V
кикілжің	N
ықшам	A
бірен-саран	PRO
білтелі	N
түйіншек	N
шікірею	V
Петербург	N
қосылмау	N
қыңырлық	N
таяз	A
домалану	V
ақыр	N
мәнерлеу	V
классификация	N
драматургия	N
аспа	N
аудандық	A
бақ-дәулет	N
грамматикалық	A
атшы	N
маңырау	V
корей	N
мінеки	PRO
жаттықтыру	V
түтіндету	V
мол	N
шұнақ	A
жирен	A
ашқылтым	A
күйлеу	V
таңертең	ADV
у	N
ландшафт	N
малту	V
асқыну	V
ізші	N
ұршық	N
қаяу	N
сомдық	A
бірдеңе	PRO
бажа	N
ажуа	N
Хақназар	N
аспаз	N
цемент	N
әдемі	A
шапан	N
алғашқы	A
категория	N
сабырлы	A
Мұстафин	N
ыңқыл	N
әртүрлі	A
кемсіту	V
тартыншақ	A
көнтек	A
аза	N
шөже	N
жиынтық	N
қарбыз	N
қитық	N
бөшке	N
бұлқу	V
саумалау	V
Нұрсұлтан	N
сыпылдау	V
ақиқаттық	N
агрессия	N
қорен	N
лексема	N
лекция	N
негізгі	A
тұтам	N
клиника	N
белгі	N
Петр	N
көрпе	N
бояулы	A
түру	V
мұртты	A
біріншілік	N
шейіт	N
ұшатын	A
сасыған	A
парақорлық	N
қабат	N
несиелеу	N
соққы	N
қадалу	V
ұшу	V
Церен-Доржи	N
прозалық	A
сатирик	N
табиғи	A
әрлі	A
қадау	V
шаршап-шалдығу	V
көруші	N
қытықтау	V
жүріс-тұрыс	N
сенім	N
Жақайым	N
ойланбай	ADV
термеші	N
кішіпейіл	A
шие	N
жылымық	N
лақап	N
гүрс-гүрс	IV
өзіндік	A
шойырылу	V
міне	PRO
ұрысу	V
идеологиялық	A
Тоқай	N
жер-су	N
айнадай	A
сүргі	N
қорғаушы	N
кім	N
ұйымшылдық	N
тәуелді	A
сөлекеттік	N
бұзу	V
түнеу	V
тұмандану	V
жыртқыштар	N
күдіктену	V
кенеп	N
апробация	N
отыру	V
арттыру	V
бүкір	A
міндеттеу	V
қону	V
жиын-той	N
жайдан-жай	ADV
басқыш	N
мансапқұмарлық	N
ызыңдау	V
жаудыру	V
орлау	V
процедура	N
іштарлық	N
елекшөп	N
сезу	V
дәуір	N
күйіну	V
дөңес	A
шақылдақ	N
бүршік	N
фонемалық	A
Роухани	N
төзу	V
кісілік	A
бел	N
кабель	N
Мәскеу	N
арыстан	N
сергектік	N
пішен	N
күреңдену	V
күрте	N
құйындау	N
абсолютті	A
квартал	N
әңгіме	N
мұсылман	N
ұрыс-керіс	N
жауласу	V
көлденеңдеу	V
Польша	N
сүйретпе	N
аяну	V
алғашқыдай	A
жарастық	N
қыз-келіншек	N
шайқасу	V
жағаласу	V
Тарланкөк	N
қолбасшы	N
әділетсіздік	N
күшті	A
Рысқали	N
кереғар	A
табысу	V
қоқыр-соқыр	N
кәде	N
сабақтастық	N
бояушы	N
сарандық	N
ақсұңқар	A
Матвей	N
либерал	N
гипербола	N
жалдамалы	A
көңілшектік	N
ақыру	V
жалпақ	A
опасыздық	N
қазымырлық	N
мұздақ	N
өкіну	V
кексе	A
шектесу	V
агроном	N
сот	N
өндіру	V
зорлық-зомбылық	N
жарыту	V
ұштау	V
мән-мағына	N
қожа-молдалар	N
асату	V
артқа	ADV
түктендіру	V
себу	V
қарақшы	N
айналдыра	N
Вашингтон	N
зобалаң	N
кекірейген	A
гимназия	N
тиянақтау	V
айран-асыр	N
табыну	V
жібіту	V
қайсы	A
қауіптену	V
патриот	N
тақталау	V
тікен	N
банкет	N
бөлшек	N
емхана	N
ғажаптану	V
шегелеу	V
бұйыру	V
ағза	N
ешкі	N
қырсыздық	N
хат	N
ардақтау	V
түбіт	N
сәулелеу	V
толу	V
рахаттану	V
бәсеңдету	V
зұлымдық	N
жалақор	N
жай-жапсар	N
көрсетпеу	V
шоқалақ	N
стақан	N
мейрам	N
толу	N
жылтыңдау	V
дыбыс	N
алаю	V
иілу	V
дәстүрлі	A
майдан	N
айықтыру	V
мәлім	A
салауатты	A
салпиған	A
ағылшын	N
самай	N
мазалау	V
Тарбағатай	N
жұғу	V
жасампаздық	N
тот	N
ысу	V
бұртаңдау	V
алданыш	N
код	N
машина	N
таулы	A
жеку	V
найзалау	V
алдын-ала	ADV
дәстүр	N
қанық	A
шектелу	V
таратпау	V
кеберсу	V
тәңірі	A
портрет	N
сәйкес	POST
қиқу	N
ілмек	N
жарақаттау	V
мама	N
ведомство	N
балкон	N
машықтану	V
шала-шарпы	ADV
ор	N
қысым	N
канцлер	N
Озғанбаев	N
күйсандық	N
маймөңке	A
сай-сала	N
мордва	N
автограф	N
уақыт	N
шайлық	N
зерттелу	V
нафталин	N
кемдік	N
триада	N
жұқа	A
керосин	N
Жамбыл	N
дағдылану	V
гараж	N
дүрмек	N
күндіз	N
ап-ауыр	A
тозық	N
Жиембет	N
шөпші	N
үйрену	V
тынышталған	A
сауу	V
толқу	V
жесірлік	N
былтыр	ADV
қарағай	N
ағу	V
жұқтырмау	V
құштарлық	N
жамылу	V
градус	N
баршылық	N
толқу	N
өзек	N
пұшайман	N
миссионерлік	N
түрту	V
саудаласу	V
асқақ	A
айталық	N
мандат	N
еріткен	A
ысылдау	V
төсеу	V
жылтырау	V
сандалыс	N
сценарист	N
жайлау	N
шарықтау	V
шуақ	N
пейіш	N
Күлпәш	N
тіл	N
Бейсенбай	N
жағу	V
сарай	N
жазулы	A
біркелкі	A
аспирант	N
ақгүл	N
буаз	A
күйген	A
әлеуметтік	A
мүмкіндік	N
алғыр	A
аларту	V
қайын	N
бос	A
үп	N
ұлықтау	V
ашып-жұмғанша	ADV
клиент	N
филармония	N
шимай	N
желөкпе	A
драгун	N
жаса	V
дамыту	V
заттық	A
қышу	V
тапсырма	N
неге	PRO
татар	N
жеңілдік	N
төл	N
әперу	V
бопсалау	V
рейс	N
азу	V
қабаттану	V
тиеу	V
серілік	N
таптау	V
бергі	A
сабаудай	A
наряд	N
қазанбұзар	N
билеу	V
шарт	N
долылық	N
комиссия	N
Камал	N
үйілу	V
аят	N
салпыншақ	N
түрліше	ADV
толқындату	V
бригадир	N
трубадур	N
қомағайлану	V
Садыр	N
түнеру	V
туу	N
құрымдау	V
қапалақтау	V
көмбе	N
өршу	V
жаяу	A
нақақ	ADV
оңтүстік	N
қайғы	N
ұйысқан	A
басқосу	N
бедеулік	N
кепкен	A
магазин	N
суыр	N
әне-міне	ADV
күңгірт	A
принципінде	ADV
ізденіс	N
мыжғылау	V
ауытқу	N
құйылыс	N
жібектей	A
аталы	A
ату	V
кенеттен	ADV
белгілену	V
соғысқұмар	A
сана-сезім	N
ойық	N
ешнәрсе	PRO
өлтіретін	A
идеология	N
ақылдас	N
академик	N
домалақ	A
зорға	ADV
ескертпе	N
талапшылдық	N
көтерем	A
өкшелеу	V
хабар-ошар	N
отырықшы	A
теңдес	A
шорт	ADV
зіл	N
броневик	N
қаршыға	N
қамқоршы	N
атқосшы	N
бағанағы	ADV
желпілдету	V
Оспан	N
кербездік	N
жекіру	V
жасу	V
зәрлі	A
таңқалу	V
жылпос	A
полковник	N
жіберуші	N
жақсылық	N
ақтал	N
қатыру	V
батпақтау	V
Исабеков	N
мая	N
әлдеқайда	ADV
шектес	A
әзіл-күлкі	N
ада	N
психолог	N
морт	A
әлсіздену	V
адасу	V
датқа	N
сала	N
түйіршіктеу	V
сәнділік	N
еңгезердей	A
тіктік	N
бұтау	V
мәміле	N
құмайт	N
оздыру	V
майып	A
ақау	N
зал	N
вокализм	N
күйсеу	V
ен	N
ұялату	V
кебіндеу	V
командашы	N
романтика	N
кездеме	N
екіталай	ADV
табыстыратын	A
әрекеттестік	N
бума	N
күлімсі	A
әділдік	N
тезек	N
дәрігерлік	A
винтовка	N
торғай	N
қарашы	N
жолдас	N
көріну	V
қауіпсіз	A
шұбат	N
Кеңгір	N
кедей	A
дүңкілдеу	V
инфинитив	N
қызғаншақ	A
асаулық	N
құйыршық	N
қызғаншақ	N
миссионер	N
кедей	N
үйреншікті	A
лайық	A
телпек	N
ода	N
өкпе-бауыр	N
опық	N
меже	N
таяқтау	V
режиссер	N
тағалы	A
жабайылану	V
сорғыш	N
құрмет	N
цифрлау	V
тонау	N
үзіліс	N
көбею	V
австриялық	N
газет	N
автор	N
тоғыту	V
тереңдету	V
дүңкіл	N
шырпы	N
тізерлеу	V
Никольск	N
қайшылау	V
әлдебір	PRO
әзіл-оспақ	N
ынтымақ	N
ақжарқын	N
жүріс	N
аялдама	N
тұс-тұстан	A
өсімдік	A
демалыс	N
дүние-мүлік	N
іркіліс	N
қаусау	V
ұсақ	A
тұру	V
жуықта	N
демек	CONJ
ішімдік	N
Зайкүл	N
кебір	A
шығанақ	N
сормаңдай	N
тіркеуші	N
кешкі	A
кішкентай	A
хал-жағдай	N
аз-аздап	ADV
әлдену	V
қышыма	N
налу	V
туған	N
сарқынды	N
бірнеше	PRO
дайындық	N
себептілік	N
зыт	N
тамыр	N
декрет	N
метр	N
байланыс	N
Мәншүк	N
екеулеп	ADV
жорық	N
келуші	A
керемет	A
технология	N
ұмытшақ	A
мінеу	V
ендеше	PARENTH
тайынбайтын	A
мутация	N
мазақ	N
ұйпалау	V
даяшы	N
ренжу	V
айлалы	A
тыныштық	N
Әзірбайжан	N
галош	N
шалу	V
жезде	N
маймыл	N
кекілік	N
нәрлі	A
ұмыту	V
айы-күні	N
жерошақ	N
қуғын	N
сүйрік	A
тығындау	V
ұшақ	N
еңбектену	V
ұшпа	A
мөлдір	A
жақтаулы	A
жанжалдасу	V
сылбыр	A
шамалау	V
аса	ADV
шежіре	N
арқандау	V
түрен	N
жұрнақ	N
заттану	V
алыстау	V
күйіп-пісу	V
сатылы	A
бітік	N
ең	ADV
сапа	N
лек-легімен	ADV
дүрбелең	N
именбейтін	A
куә	N
сондағы	A
комедия	N
Түркістан	N
лашық	N
және	CONJ
Майра	N
аруақтану	V
әлгіде	ADV
прокуратура	N
адалдау	V
уәделі	A
шырын	N
топтау	V
жалшы	N
жеңілтектік	N
құм	N
бұзаулау	V
алау	N
желдірме	N
сорғалату	V
шолпы	N
айқын	A
зарығу	V
ему	V
Сәдір	N
міндет	N
молшылық	N
тіркеме	N
қайтарма	N
дифтерия	N
албан	N
мазасыздану	V
көздеу	V
Тәжікстан	N
қалдыру	V
телу	V
нақ	ADV
емін-еркін	ADV
қалыптау	V
мәртебелі	A
истребитель	N
күлкі	N
мысыр	N
қолпаштау	V
шығыр	N
арғымақ	A
дауа	N
тағылым	N
паналау	V
балгер	N
айналдыру	V
түрлену	V
өрбіту	V
Тәшенов	N
ашиды	V
алғысөз	N
қысырақ	N
безендіру	V
көде	N
босқа	ADV
зәр	N
лексикология	N
апатай	N
ықшамдау	V
тамақ	N
қусыру	V
сағыну	V
қайнатынды	N
астық	A
зоология	N
өлермендік	N
астық	N
кеңес	N
өңу	V
бұл	PRO
араластыру	V
тоқылдату	V
алапат	A
қышқыл	A
бүгежектеу	V
қарама-қайшы	A
тырнау	V
трубка	N
атышулы	A
қушық	A
арыздану	V
арғы-бергі	N
жиренішті	A
айыл	N
кәзір	ADV
сахналық	A
лайлау	V
өкілеттік	N
әпке	N
қабыршақ	N
ықылық	N
тілші	N
етіс	N
қыршаңқы	A
қоян-қолтық	ADV
қысқаш	N
жұқарту	V
темірқазық	N
түстік	N
нәлет	N
пайымдау	V
кино	N
күресу	V
қазымыр	A
шалықтау	V
бұқа	N
зардап	N
қорқақ	N
әрбіреу	PRO
сигнал	N
білік	N
жатырқау	V
қорқақ	A
ширақ	A
сыртта	ADV
ұялшақ	A
шұғыл	ADV
түркі	A
білте	N
бөз	N
қарғыс	N
номер	N
ожау	N
есу	V
терминология	N
анау-мынау	PRO
қи	N
сыбызғы	N
жасық	A
егінші	N
табыс	N
баста	N
жазалайтын	A
еріген	A
тазы	N
қарлыққан	A
алғышарт	N
үшінші	NUM
Шұно-Дабо	N
қабан	N
еуропалық	N
әскери	A
келтіру	V
секіру	V
шелпек	N
қайғылы	A
қадамдау	V
табу	V
райхан	N
ажуалау	V
парламент	N
бейбітшілік	N
дәулет	N
текемет	N
болмау	V
әкім	N
ұйқасу	V
мемлекеттік	A
көңіл	N
үйдей	A
дастархан	N
егер	CONJ
ауыздық	N
мезгіл-мезгіл	ADV
арын	N
бұлдыр	A
атом	N
салтанат	N
төраға	N
көріпкел	N
келешек	A
жуық	A
шөлмек	N
түсіну	V
аймалау	V
психология	N
ес	N
қақпақша	N
территория	N
асық	N
куәландыру	V
жағымпаздану	V
прапорщик	N
гүлзар	N
қарасұр	A
кертартпалық	N
тонна	N
мотор	N
соматикалық	A
қызыққыш	A
Арғынат	N
сүйкеу	V
жарты	A
жазғытұрым	N
мәйітхана	N
күлтелену	V
шетел	N
топыр	N
базаршы	N
молда	N
тарихшы	N
саясатшы	N
ұлан	N
ерекшелеу	V
апталу	V
кондуктор	N
лүпілдеу	V
басқару	V
арбитраж	N
батарея	N
әлди-әлди	INTJ
грамм	N
өткізу	V
техника	N
қадам	N
аттам	N
жылмаңдау	V
ат-көлік	N
таласты	A
шалбар	N
жан-жағы	N
шоқпар	N
егеу	V
жіті	A
құрметтеу	V
пікірлесу	V
Акунин	N
сермеу	V
жаттық	N
әлденендей	A
аз-ақ	ADV
байланысшы	N
айыратын	A
шамшырақ	N
тигізбеу	V
құрту	V
кеңею	V
жақпау	V
Виноградов	N
модернизациялау	V
Жансүгіров	N
ағылу	V
ер-тоқым	N
жансыздану	V
жақша	N
әпсәтте	ADV
сенімділік	N
жұп-жұқа	A
қынап	N
тар	A
қуаныш	N
кинотеатр	N
бұрғышы	N
қылжақтау	V
салы	N
Қайдар	N
шырғанақ	N
қарындаш	N
қырылдау	V
мәре	N
кресшілер	N
етене	ADV
талассыз	A
төбешік	N
бәкі	N
пикет	N
ар-ұят	N
жапқызу	V
көк	A
араздасу	V
әсер	N
атлетика	N
сүюші	A
қалшылдау	V
командир	N
қайту	V
шопан	N
обоз	N
Мұстапа	N
пысықтық	N
жету	V
апалы-сіңлілі	N
диван	N
сызу	V
тақсыр	N
бүтіндік	N
ыссылау	V
иелік	N
сарт-сұрт	IW
секілдену	V
жетістіру	V
шешу	V
руль	N
өткел	N
жүқаяқ	N
білгенінше	ADV
мосы	N
жарылқаушы	N
мэр	N
шапқыншы	N
нақты	A
ашкөздену	V
қатайған	A
оңбаған	A
күздік	A
фонетика	N
сынап	N
сындыру	V
әдеттену	V
ет	N
тыныш	A
ателье	N
қараторғай	N
Бабасұлтан	N
жәдігер	N
эпизод	N
алашақ	N
шұғыла	N
мұз	N
төмен	A
тиіп-қашып	ADV
бетпе-бет	ADV
аузы-басы	N
сулы	A
диабет	N
кесел	N
бақа	N
ығай-сығай	N
арка	N
тұмар	N
Ақсу	N
қаражат	N
әрі-бері	ADV
қарлыған	N
дүңк	N
інжу	N
ұтымды	A
атака	N
дұрыстау	V
қоржын	N
түпсіз	A
желімдеу	V
лашын	N
сценарий	N
бағалау	V
дүмбілез	A
байырғы	A
масштаб	N
шақыр-шұқыр	IW
Сәкен	N
тарамыс	N
сейіл	N
бешпент	N
еліту	V
кездік	N
сампылдау	V
дауылпаз	N
қию	V
әлдебіреу	PRO
кеуделі	A
кітапхана	N
сынақ	N
без	N
жетек	N
жаңқа	N
үндістан	N
жарқылдау	V
әрекеттену	V
намаз	N
жыпылықтау	V
парсы	N
ырғақтық	N
ұрлау	V
Малайсары	N
радикулит	N
қаңқылдау	V
ынтық	N
қанша	PRO
ойламастан	ADV
темекі	N
ырым	N
аумау	V
қапелімде	ADV
фотометр	N
таса	N
жүздік	N
балақай	N
шалдық	N
қазымырлану	V
сарымсақ	N
махаббат	N
істеуші	N
сұхбат	N
тасымалы	A
түйін	N
шит	N
кесетін	A
метод	N
былқылдақ	A
мінез-құлық	N
желбіреу	V
ұйыған	A
сіңір	N
быршу	V
өлік	A
шатысу	V
профессионал	A
өрік	N
прокат	N
селеу	N
кеще	N
қырағылық	N
өшпенділік	N
өршіту	V
атану	V
мереке	N
шөбере	N
ішкіш	N
аламан	N
данышпан	A
үндемес	A
тыңшылық	N
тілерсек	N
Нардай	N
желбезек	N
данышпан	N
емен	N
шамалы	ADV
үстем	A
бастасу	V
құрттау	V
Мстислав	N
көсе	A
тыстау	V
ғұн	N
таттыру	V
шашақтау	V
бет	N
статус	N
топталу	V
зақымдану	V
көкіректену	V
орынды	A
айналым	N
көкейтесті	A
әбден	ADV
ашығу	V
манаурау	V
қабылдаушы	N
сигек	N
психолингвистика	N
фильм	N
кимелеу	V
жандану	V
талдау	V
шәкірт	N
шытыра	N
ителгі	N
диапазон	N
хакас	N
тіпті	ADV
атан	N
мұнда	PRO
премьер	N
галифе	N
жалғыз-ақ	A
азырқану	V
күжірейту	V
қисаю	V
ақсаңдау	V
айдалатын	A
қамығу	V
әмеңгер	N
ау	N
қасиетсіздік	N
гвардия	N
бұлдану	V
Жәуке	N
бұлт	N
қамқорлық	N
Мұхамед-Шайбани	N
шапақ	N
арзандату	V
социализм	N
экономика	N
айтақтау	V
шоқы	N
генерал	N
кальций	N
тайғақ	A
мәслихат	N
имену	V
Махамбет	N
теміржол	N
асылу	V
үлгеру	V
көке	N
қиыр	A
көму	V
боран	N
алкүрең	A
орал	N
жасқаншақтық	N
қыстау	N
басталу	N
өрім	N
біту	V
қарын	N
ірілену	V
рахат	N
ыңғайсыз	A
шабадан	N
бақыру	V
некелі	A
ұйықтамау	V
бұйығу	V
жүктілік	N
шерменде	A
кішігірім	A
қамту	V
шүйіркелесу	V
мерген	A
кемтар	A
айлалау	V
қылыш	N
кес	V
көңілшек	A
қарыс	N
шеттеп	ADV
репортаж	N
түйнек	N
апыр-ай	INTJ
тез	A
монитор	N
Ахметов	N
уәж	N
қырғын	N
бұрғы	N
геологиялық	A
уақтау	V
январь	N
сұлулық	N
қату	V
серік	N
мың	N
келешекте	ADV
істелінген	A
жұмсарту	V
орын	N
іріткі	N
азын-аулақ	N
қақырық	N
Кенжетай	N
салдыр	N
кешегі	A
тырысқақ	A
егу	V
күмістеу	V
сірне	N
дұға	N
жырау	N
жемдік	N
таңдай	N
мәлімдеме	N
жарайсың	INTJ
етек	N
көреген	A
тотығу	V
айдаушы	A
жоспарлы	A
қарым-қатынас	N
пай	N
жүрелеу	V
еріту	V
репертуар	N
көкжал	A
кадет	N
жақсы	A
қаралы	A
ишан	N
жәшік	N
саяз	A
жанат	N
құмалақ	N
келекелеу	V
программа	N
бісміллә	INTJ
жаңғырық	N
кеңірдек	N
монолог	N
беткей	N
бақыраш	N
добалдай	A
комсомол	N
ескірген	A
сужүрек	N
армандас	N
мейірімділік	N
тиетіні	A
амандық	N
алшаю	V
зенит	N
зер	N
арнаулы	A
Шыңғыс	N
шулы	A
назалану	V
жетім	N
солғын	A
жетелеу	V
жуыну	V
солға	ADV
ертелі-кеш	ADV
жырым-жырым	A
тыртықтану	V
абстрактілі	A
Хасан	N
интеллигенция	N
қойын	N
құрал-жабдық	N
иероглиф	N
қызық	A
көрнекті	A
кітірлеу	V
ауыс-түйіс	N
билеп-төстеу	V
әулиелік	N
құлазу	V
шаруа	N
әл-қуат	N
жалдану	V
газдалған	A
әшкерелеу	V
алдаусырату	V
қоян	N
тербеліс	N
сабын	N
жоспарлылық	N
біз	PRO
тастау	V
нану	V
суат	A
шұға	N
Әуезов	N
ұсталу	V
Ербол	N
түз	N
бұлдырау	V
бейкүнә	A
шөлдеу	V
арқалау	V
күлкілі	A
египеттік	N
соттау	V
сынау	V
еңіс	N
дәріхана	N
денсаулық	N
бықсыту	V
жалғастыру	V
соғым	N
сәйкестік	N
антонимдер	N
кемпірқосақ	N
толғақ	N
кәріп	A
айқындылық	N
сүйсінерлік	N
ағын	N
жіп-жіңішке	A
тұрыс	N
дөңгелек	N
жөке	N
дөңгелек	A
Владимир	N
ұстара	N
астыңғы	A
қылтанақ	N
қарш	N
уәделескен	A
жерлеу	V
жылнама	N
айыптау	V
қаңғыру	V
үзінді	N
гайка	N
той	N
доцент	N
рамазан	N
бронь	N
су	N
жалғыз	A
қонақасы	N
лықсу	V
етеккір	N
сайтан	N
шарлау	V
сфера	N
әлсіреген	A
көпірту	V
тегін	ADV
серіктес	N
перне	N
ши	N
сығылысу	V
аймақ	N
қаудырлау	V
шорқақтық	N
қылық	N
вулкан	N
қайшы	A
логикалық	A
түсіністік	N
уақиға	N
бағдарламалық	A
адыр	N
шал	N
борсу	V
ауырта	ADV
дәріханашы	N
тәте	N
субстанция	N
иір-иір	A
қалақтау	V
анатомия	N
діңкелеу	V
білімдар	A
шуда	N
жұпыны	A
жұтаң	A
шұқанақ	N
саз	N
Әріпбаев	N
ақын	N
үлкею	V
жортуыл	N
дімкәс	A
көрік	N
трактат	N
ақсау	V
боқтық	N
июль	N
бассалу	V
жаурау	V
шәугім	N
тандыр	N
төсеніш	N
кеуделеу	V
сырнай	N
қопаңдау	V
қымбат	A
дәрілік	A
өкіл	A
арлы-берлі	ADV
желкен	N
алақандағыдай	ADV
іш	N
қаңбақтай	A
нақыш	N
ойнақтау	V
табыт	N
ректор	N
бітпеу	V
саудырау	V
әнеугүні	ADV
көгершін	N
бақыр	N
үйшік	N
антенна	N
телефон	N
сүтті	A
түпкі	A
безбүйрек	A
жасаулы	A
соз	N
селекция	N
Панфилов	N
әділетті	A
әзірше	ADV
пластмасса	N
бақылайтын	A
жамбас	N
Шашау	N
іргетас	N
әзіл	N
екіжүзділік	N
мойыл	N
қарсыласу	V
қысу	V
таныту	V
ойдағыдай	ADV
сүйініш	N
энцефалит	N
шапқыншылық	N
тоғыз	NUM
Қырмызы	N
жалақы	N
өт	N
қияңқы	A
жиек	N
азаптану	V
абаттандыру	V
сахналау	V
ешбір	PRO
қасақана	ADV
өзімшілдік	N
ластау	V
жеміс-жидек	N
сыз	N
қылмыс	N
старшина	N
жиіркенішті	N
меншіктеу	V
бауырсақ	N
Ерсай	N
жыңғыл	N
сыйлы	A
үлгі-нұсқа	N
былшылдау	V
әшекейлеу	V
айырбас	N
кербез	N
пана	N
сыздау	V
даурығу	V
жол-жоба	N
несібе	N
сыбыр	N
тап	N
толтыру	V
энциклопедия	N
жігерсіздік	N
тозу	N
кейіндеу	V
Пугачев	N
патенттелген	A
классик	N
сорт	N
қамал	N
үйірлеу	V
урядник	N
Алакөл	N
арылу	V
шайынды	N
зергер	N
коллектив	N
қадала	A
жағалай	ADV
қасиет	N
өңдес	A
тақта	N
орын-орнына	ADV
қаншалықты	ADV
ыршу	V
зыңылдау	V
жабыңқы	A
армия	N
сүйікті	A
вирус	N
жол	N
қағыстыру	V
объект	N
тігу	V
мардымды	A
мүлік	N
екпе	N
сөздік	N
өзіне-өзі	ADV
жөндейтін	A
тоғай	N
мылқау	N
төгу	V
желдеткіш	N
қолдау	V
ағыту	V
дербестік	N
өктем	A
іру	V
у-шу	N
жасарту	V
альтернатива	N
тайыну	V
айырым	N
қамзол	N
қауашақ	N
наубайхана	N
семсер	N
көздеуші	N
үрей	N
аңызак	N
ерттелген	A
ереуілші	N
байлайтын	A
ревком	N
жұбату	V
шыңыл	N
фельдмаршал	N
ауызекі	ADV
дәл	A
быжылдау	V
төтелеу	V
Павлодар	N
нақұрыс	N
жауынгершілік	N
торуылдау	V
келіп-кету	V
немене	PRO
күнбағыс	N
тайга	N
соттасу	V
мұң	N
ала-құлалық	N
бүлік	N
түзу	A
театрлық	A
қосмекенді	N
қима	N
сеңгір	N
драматург	N
байласу	V
погон	N
жасауыл	N
тілектестік	N
шаршы	N
отасу	V
ту	N
асқындау	V
шаршы	A
кесу	V
алаөкпе	N
шеберхана	N
айнымайтын	A
жәрмеңке	N
бертін	ADV
алдыңғы	A
ілтипат	N
сөндіру	V
ардагер	N
арс	N
шығарушы	A
ұқсау	V
шайнек	N
саңырауқұлақ	N
түтіндеу	V
шырқырау	V
сәби	N
аңдау	V
суреткер	N
үйірілу	V
марка	N
намысқой	A
көкек	N
біртіндеп	ADV
үміткер	A
шапыраштану	V
жүйтку	V
консул	N
ырымшыл	A
умаждау	V
дүниелік	A
өркен	N
аңдай	ADV
зерде	N
қуару	V
албасты	N
барқын	N
қарабет	A
мейірбандық	N
топтау	N
жабысқақ	A
елту	V
құйқылжыту	V
жәрдемақы	N
корректор	N
айқыш-ұйқыш	A
қиық	N
сәулет	N
түрегелу	V
әп-сәтте	ADV
мұрагер	N
уролог	N
секция	N
оң	A
экран	N
үрім-бұтақ	N
кісімсу	V
жеткіліксіз	A
дүлей	A
аман-есен	ADV
организм	N
кейбіреу	PRO
сортаң	A
алдаспан	N
жабдықтау	V
толықтық	N
қумай	N
мерекелеу	V
әңгімелесу	V
арманшылдық	N
пәр	N
кінәрат	N
әдіп	N
жел	N
этикет	N
кіршік	N
курорт	N
кент	N
мығым	A
автономиялық	A
тамұқ	N
енші	N
жыр	N
шумақтау	V
семантика	N
сырғанау	V
семантикалық	A
лауреат	N
қалаушы	N
оқшау	A
жедел	A
қағидалы	A
тармақ	N
кесек-кесек	A
фотосурет	N
кебіс-мәсі	N
кәдір	N
айқас	N
десерт	N
абдырау	V
інішек	N
жүру	V
жағдай	N
аунау	V
науат	N
енжар	A
конференция	N
эволюция	N
жайбарақаттық	N
барқыялдау	V
бөлінушілік	N
фаза	N
бұлттану	V
желкілдеу	V
себет	N
бастық	N
кітапханашы	N
идіру	V
фашистік	A
антропологиялық	A
Талғат	N
тағы	A
дайындаушы	N
ұмтылыс	N
инспектор	N
бота	N
жырық	A
Ницца	N
тұмандау	V
болат	N
әнұран	N
жарату	V
түр	N
шар	N
шайтан	N
үйме	N
қымтану	V
латыш	A
басылым	N
таңбалау	V
жүзбе-жүз	ADV
Абакир	N
жұмыскер	A
мызғымас	A
тығыздап	N
қалқа	N
жіберу	V
іргелес	A
әуелгі	A
таңғаларлық	A
айбыну	V
тығыздалу	V
ырза	N
ерегісу	V
күнәқар	A
қырлау	V
магнит	N
әдейілеп	ADV
қызғаныш	N
сым	N
кіршілдеу	V
бастаушы	A
көнбеу	V
суыру	V
ойпаң	N
ұлықсат	N
госпиталь	N
айтысу	V
бауыр	N
сырға	N
мүк	N
сараң	A
тапқыр	A
баспана	N
жайма	N
тарығу	V
жайпақ	A
өңеш	N
құю	V
күншығыс	N
қамау	V
тұнжырау	V
образ	N
ғаріп	A
діншіл	A
ызалану	V
жөндеу	V
ынтымақтастық	N
жетілдіру	V
шек	N
бурят	N
боздау	V
жекелеу	V
тоқырау	N
Азамат	N
дәт	N
ұшқыш	A
қосарлау	V
ескі	A
көкжиек	N
таңдану	V
интерпретация	N
тура	N
сасыту	V
тершу	V
қиыршық	A
ояз	N
әлділік	N
келі	N
профессор	N
ағыл-тегіл	N
көбелек	N
лақтау	V
бір-бірден	ADV
тыраштану	V
қайны	N
салыстыру	V
алаша	N
оқушы	N
шәйнек	N
ентігу	V
шу	N
бата	N
сүйсіну	V
Елшібек	N
көздік	N
қысыр	N
ареал	N
бала-шаға	N
интеграция	N
ынтықтыру	V
саты	N
сықылықтау	V
облыс	N
зекіру	V
казарма	N
дымқыл	A
дәмдес	A
масаттану	V
жаю	V
пұрсат	N
афоризм	N
сыпыру	V
әттең	INTJ
іркілдеу	V
ауан	N
түбегейлі	ADV
құнығу	V
қылымсу	V
стипендия	N
жалғау	V
күйек	N
колония	N
арлылық	N
астамшылық	N
инфляция	N
жапсар	N
өлімсіреген	A
күй-жай	N
лық	ADV
