чиген	V
мелодрама	N
әдип	N
баскак	N
күрештер	V
күчтәнәч	N
иллюминатор	N
бормалы-сырмалы	ADJ
якынайткыч	N
компиляция	N
бугазла	V
такылдык	ADJ
тилер	V
җепшек	ADJ
мыңгырда	V
җилбәзәк	ADJ
Шсән-сау	ADJ
бохар	ADJ
әлсерәткеч	N
плантация	N
майор	N
авантюра	N
кызын	V
оптимизм	N
әсәрлән	V
өчпочмак	N
кочаклат	V
каргылда	V
Шлер	V
дискриминация	N
декларатив	ADJ
җәүһәрлә	V
рея	N
диоптрия	N
ир-ат	N
тыелгысыз	ADJ
җып	PREF_ULTRA
зарарла	V
сиксән	NUM
уртача	ADJ
үткел	N
коктейль	N
ызандаш	N
галим	N
балакай	N
инк	N
комизм	N
хәвефлән	V
кыпчак-татар	N
неофрейдизм	N
Шдарә	N
олактыр	V
кызылкүз	N
ялтыр	ADJ
каучук	N
көч-дәрт	N
измә	N
резеда	N
юнәт	V
квадрат	N
йокла	V
аңгарт	V
багбостан	N
матурайт	V
авиа	ADJ
антология	N
эпитет	N
кышкы	ADJ
муенчак	N
гаярь	ADJ
биология	N
йомран	N
пычакла	V
кушкөбәк	N
тал-тирәк	N
локомотив	N
ликвидациялә	V
тарма	N
тромбон	N
поршень	N
филчек	N
һиҗри	ADJ
фотохроника	N
аксельбант	N
гальваник	N
шимпанзе	N
эргә	N
майя	N
җәзала	V
климат	N
лайнер	N
турсай	V
көнаралаш	ADVV_NEG
германияле	N
викинг	N
пыранлат	V
чәбәйкә	N
корт	N
терраса	N
эленке-салынкы	ADJ
картайт	V
чылат	V
солых	N
бетәр-бетмәс	ADJ
чаштырда	V
йөрәк	N
методологик	ADJ
донор	N
теорема	N
авантюрист	N
гиповитаминоз	N
хөтбә	N
сауры	N
касыйдә	N
импровизатор	N
субүләр	N
мамык	N
күзалла	V
илгәзәк	N
икенчеләй	ADV
хәстәр	N
черек-чарык	N
лампада	N
ман	V
абсолютизм	N
баш-күз	N
поливитамин	N
йозак	N
фаталист	N
беренчел	ADJ
бульдог	N
пектин	N
газапла	V
савыр	N
тикле	POST
демобилизация	N
графин	N
кудырткыч	N
җирәндергеч	ADJ
бизмән	N
почта	N
прораб	N
гастроль	N
пешер	V
Шнвентарь	N
имчәктәш	N
спекулятив	ADJ
агулан	V
кысынкылан	V
тәрәтханә	N
аллалаштыр	V
гөслә	N
багышлан	V
подданный	N
ваучер	N
инструктор	N
ризала	V
вәхаләнки	ADV
мәймүн	N
кәстрүл	N
присяжный	N
түгәрәк	ADJ
икән	PN
эвакогоспиталь	N
мекердә	V
беркайдан	ADV
эз	N
субай	N
рамкала	V
даган	N
фламинго	N
рефлектив	ADJ
курсистка	N
чыңгыра	V
редис	N
җилдер	V
рак	N
куштояклылар	N
смена	N
кыйнал	V
сланец	N
чәчтамыр	N
күләгәлә	V
комик	N
апатит	N
маховик	N
сеңер	N
блиндаж	N
ысылда	V
газап	N
шпак	N
парадокс	N
ачыткы	N
караҗиләк	N
полиция	N
мәснәви	ADJ
чакматаш	N
декорациялә	V
планшетка	N
тоткарла	V
магма	N
венгрияле	N
ваксын	V
нейтраль	ADJ
күз-колак	N
вәкаләт	N
сез	PN
сызгырт	V
җитез	ADJ
зерә	ADVV_NEG
юллат	V
уйдык	N
информация	N
шуклан	V
элә-танагы	N
фәлән	PN
төбәк	N
тидер	V
ухла	V
типограф	N
түшәк	N
дюжина	N
әшнәлә	V
аерылгысыз	ADJ
гөнҗәлә	N
кушымча	N
метонимик	ADJ
Шхахайла	V
бөрелән	V
кирәкле-кирәксез	ADJ
нарком	N
сателлит	N
каек	N
көмешкә	N
келья	N
солтанат	N
суллык	N
төпчек	N
кодировка	N
йотымла	V
йомшар	V
үк	CNJ
ясал	V
симерт	V
манифест	N
нәшрият	N
сыраханә	N
металла	V
акырт	V
катна	V
әйләнеч	ADJ
җиһаз	N
кыюла	V
массачыл	ADJ
невропатолог	N
лашман	N
сөйләт	V
туктал	V
чия	N
амперметр	N
аң	N
бәйләнчек	ADJ
күнчек	N
ничәмә-ничә	ADVV_NEG
дәртсен	V
күңел	N
психика	N
кавыклат	V
газазил	N
коми-пермяк	N
өзел	V
туйдыр	V
документлаштыр	V
шикаять	N
Шркенчелек	N
нәзакәт	N
һинд	N
борна	V
уңайлат	V
ритм	N
эфемер	ADJ
чатырда	V
күрәнчәләр	N
бик	ADV
кокарда	N
пыялала	V
верховный	ADJ
манара	N
әйләнгеч	ADJ
ячейка	N
пульман	N
бизәл	V
миллиардер	N
бетерен	V
миңгерәүлән	V
шапырын	V
яктыр	V
кондырак	N
кыркыт	V
аныклан	V
шпик	N
берара	ADVV_NEG
кәфен	N
каты	ADJ
горчица	N
салмак	ADJ
куәтсезлән	V
эзәр	N
римлы	N
пульсатор	N
клавиатура	N
сип	PREF_ULTRA
җәһәннәм	N
баткаклан	V
батыр	V
сноб	N
большевизм	N
батыр	N
искиткеч	ADVV_NEG
сай	ADJ
үзәк	N
сукалат	V
башкорт	N
коммуникация	N
челлә	N
патриций	N
свеча	N
бортмеханик	N
авиадвигатель	N
регенерация	N
котыл	V
пермяк	N
агностицизм	N
сүллән	V
шалтырат	V
марксистик-ленинчыл	ADJ
айва	N
прокурор	N
ярканат	N
каротин	N
изү	N
каптыргыч	N
колибри	N
сугыл	V
кадер-кыйммәт	N
зәһәр	N
себеркәч	N
берәмлеклә	V
җәбраил	N
координат	N
аяла	V
арендатор	N
чүгәләт	V
профан	N
толпар	N
вожатый	N
ярашлы	ADJ
тәбарәк	N
инкогнито	ADV
драматургия	N
таркаулан	V
тумран	N
экстрасенс	N
беразга	ADVV_NEG
рычаг	N
тест	N
кутыр	N
иңкел	N
галерея	N
тромбофлебит	N
аралия	N
каплан	V
кучкыл	ADJ
пекарня	N
кафельлән	V
бәндә	N
шомлан	V
акгвардия	N
бервакытны	ADV
мескен	ADJ
зиннәтлә	V
аксөяк	N
морфолог	N
табыштыр	V
мөштек	N
каударлан	V
церемониал	N
тариф	N
инквизиция	N
цезий	N
инфекцион	ADJ
флексия	N
аваз	N
беләк	N
адреслан	V
чыелдат	V
кечелек	N
сишәмбе	N
киноаппаратура	N
коллега	N
фонограмма	N
каркылда	V
ультиматум	N
специфика	N
киҗе	N
диаметр	N
көре	N
кодрәтлән	V
хрусталь	N
уйна	V
ваксала	V
румын	N
директор	N
өлкәнәй	V
түбәнәйт	V
касмак	N
пан	N
ула	V
шәһәрлә	V
геральдика	N
һәр	PN
гимнастика	N
подполковник	N
ат	V
җөрьәт	N
кашавай	N
кярханә	N
арамей	N
куркыт	V
ат	N
анархизм	N
ула	N
бүлемтек	N
букмекер	N
салкын	ADJ
документ	N
бронхография	N
батман	N
кабихә	N
официантка	N
поролон	N
элек	PN
Шнкяр	N
чардуган	N
агитколлектив	N
җилтерәт	V
рәте-башы	N
автоматика	N
натуралистик	ADJ
лунатизм	N
шШгырь	N
политграмота	N
формала	V
гаилә	N
балкалак	N
тандем	N
кок	N
ортопедик	N
әйлән-бәйлән	N
дШ	V
тузанла	V
дискант	N
тигезләт	V
ләкәтә	N
төян	V
поло	N
кызмачалык	N
сусын	N
милләтара	ADJ
кабала	N
буй-буй	ADJ
уй	N
декада	N
кәлшә	N
перекись	N
асаба	N
Шнк	N
клавир	N
рикша	N
корректура	N
ярышташ	N
йомарлак	ADJ
калканчык	N
билә	V
гозерлән	V
үксе	V
Шләс	ADJ
уй	V
турагыч	N
чалпу	ADJ
ситуация	N
пас	N
биләүлә	V
нейрохирургия	N
баламут	N
уемла	V
вагай	V
бөтәйт	V
йокымсыра	V
агарт	V
чылтырда	V
инфантиль	ADJ
чамала	V
пушка	N
геологоразведка	N
чукындыр	V
урла	V
логарифмик	ADJ
сирәкләт	V
электричка	N
ипотека	N
прогул	N
җәбер-золым	N
янычар	N
күптәнге	ADJ
чатанла	V
бәләк	N
наратбаш	N
синоптик	N
тамгала	V
буын	N
хамсин	N
Шкона	N
мөшкә	N
шпионаж	N
чатак	ADJ
Шртәнгә	ADV
катюша	N
палуба	N
педагог	N
алсан	N
коррекция	N
карынчык	N
хәтем	N
фразеология	N
өялды	N
инсафсызлан	V
тап	PREF_ULTRA
саранча	N
рубин	N
мишәрчәлә	V
иллюстрация	N
револьвер	N
латифундия	N
радиорубка	N
үзйөрешле	ADJ
цитата	N
иррационализм	N
планерла	V
пфенниг	N
автотрасса	N
бәз	N
лаконик	ADJ
алыча	N
йокымсырат	V
ганимәт	N
кыю	ADJ
кабинка	N
рәнҗет	V
мияулат	V
чәкәнбаш	N
йөзлә	V
феномен	N
либераль-буржуаз	ADJ
кыйбланамә	N
кайтарыл	V
иркенчелек	N
яраксыз	ADJ
тетәлә	V
тәпәч	N
археолог	N
романтизм	N
зурла	V
Шләм	ADJ
ашлан	V
мал-мөлкәт	N
ала-кола	ADJ
алай	PN
тематик	ADJ
калак	N
диссонанс	N
хатлаш	V
ә	CNJ
бәке	N
моралист	N
сыныклык	N
кыштыр-кыштыр	ADV
яланаяк	ADJ
әүкат	N
кушылдык	N
шлам	N
иртән	ADV
тирбәл	V
ярдәмлә	V
йөрердәй	ADV
тәслим	N
ауна	V
җыйнакла	V
каешлы	ADJ
стационар	N
тезис	N
культивация	N
илһам	N
дәҗҗал	N
чая	ADJ
мамыкбаш	N
теркәт	V
кофеин	N
кам	N
Шртүк	ADV
маляр	N
пар	N
тай	N
акшар	N
граф	N
рация	N
пенсионер	N
түмгәклән	V
фәлсәфШ	ADJ
хыялый	ADJ
ординатор	N
күркәмләт	V
раушан	ADJ
тай	V
хаҗәтханә	N
чир	N
воевода	N
галәка	N
хонса	N
авыру	N
арча	N
картуз	N
дуамаллан	V
башваткыч	N
рашпиль	N
инволюция	N
ботинка	N
казамат	N
казган	V
кунычла	V
костер	N
шәрәлә	V
төз	ADJ
маташ	V
героин	N
төбәт	V
култыкса	N
подпись	N
гирокомпас	N
партизан	N
республика	N
штабист	N
мәй	N
этлән	V
активла	V
киноактер	N
эксплуатациялән	V
магнитофон	N
руник	ADJ
сыйпала	V
гносеология	N
кайтаргыч	N
ташын	V
климакс	N
көтү	N
полк	N
бидон	N
мөлаем	ADJ
әлсерәт	V
келтерә	V
як-ягым	N
кытыклат	V
олимпия	N
Шнде	CNJ
адым	N
скипидар	N
вольт	N
әдәбиләштер	V
концентрация	N
зыяндаш	N
компетентлы	ADJ
каурыйлан	V
инеч	N
улан	N
лыгырдык	ADJ
латвияле	N
актар	V
әкәмәт	N
бүлтерек	N
шик	N
бюро	N
ишлә	V
акылсызлан	V
брынза	N
каплавыч	N
аденома	N
регалия	N
турбобур	N
җәйран	N
автоспорт	N
маска	N
шадралат	V
хәстәлән	V
эквилибристика	N
утын	N
акселератор	N
түндербаш	N
радиоалгыч	N
онла	V
гейша	N
тоткын	N
кәҗәлә	V
кечек	ADJ
тулган	V
савыктыр	V
тубалбаш	N
җыел	V
эпидемия	N
бик	N
агитплакат	N
пеләшлән	V
иртәгә	ADVV_NEG
стабилизация	N
сөйләшен	V
кайнар	ADJ
морҗа	N
чәчкәлән	V
нәзер-нияз	N
сифон	N
бәрхет	N
майка	N
сигезпочмак	N
сәмум	N
маймыч	N
чапкыр	ADJ
бәрәңге	N
челән	N
лезгинка	N
торнадо	N
дәһри	ADJ
кавалерия	N
көнозын	ADV
аккорд	N
перес	N
ыштансызлан	V
миллиметр	N
үткен	ADJ
орден	N
неологизм	N
таптат	V
сөйләм	N
тончык	V
өлгеш	V
Шлхан	N
изоляция	N
кашлак	N
руда	N
элгеч	N
миллиардлаган	ADJ
ныклык	N
магик	ADJ
аягүрә	ADVV_NEG
алкалан	V
кип	V
шланг	N
июль	N
хуш	ADJ
тротуар	N
капрал	N
ябык	ADJ
әүвәлдән	ADV
нагайка	N
исәрлән	V
методология	N
цель	N
юнәй	V
тасвирлама	N
унификациялә	V
кыса	N
җилпе	V
бакра	N
биография	N
бацилла	N
әчкелтем-төчкелтем	ADJ
фундаменталь	ADJ
тоталитар	ADJ
аерым	ADJ
өлкә	N
җырла	V
терәк	N
профессионализм	N
тореадор	N
капсюль	N
күкрә	V
астарла	V
парадоксаль	ADJ
эчемлек	N
уремия	N
татарстан	N
монтажлан	V
булдыксызлан	V
консервациялә	V
кыяс	N
фотон	N
гол	N
федерация	N
кәлҗемә	N
назла	V
күперт	V
альтруист	N
чимал	N
кыстат	V
үкерт	V
вольт-ампер	N
укы	V
күренмәле	ADJ
мифик	ADJ
рәйхан	N
Шнеш	N
компонент	N
проектор	N
агач-богач	N
пачкала	V
догматик	ADJ
чар	N
шапито	N
дама	N
вердикт	N
сулык	V
көньяк-көнчыгыш	N
нас	N
хәзерге	ADJ
алтатар	N
папуас	N
формула	N
гагауз	N
миң	N
карлыган	N
аут	N
шифоньер	N
зимагур	N
курай	N
персонаж	N
чәнчел	V
ятлат	V
ярсын	V
дизель	N
газамәт	N
утырт	V
бушан	V
кеда	N
яси	N
туксын	V
мөндәриҗә	N
күрем	N
абордаж	N
маниакаль	ADJ
чумгалак	N
зиһен	N
ташлат	V
сальто	N
сәламәтлән	V
вә	ADJ
трюк	N
бөгештер	V
янәдән	ADVV_NEG
билгеләмә	N
бишбылтыр	ADV
хәйләлә	V
дизентерия	N
бант	N
политбүлек	N
коры	V
кычыт	V
кузак	N
төшмә	ADJ
сорал	V
атлат	V
изотоп	N
төкерт	V
эр	V
модистка	N
ярыл	V
нефтьүткәргеч	N
табут	N
кәнә	N
фамильяр	ADJ
костюмер	N
балалайка	N
нәләтлә	V
тоз	N
чорнат	V
бумеранг	N
могҗиза	N
ярчык	N
угыз	N
билге	N
квант	N
туган-үскән	ADJ
яшәр	ADJ
тегендә	ADV
туба	N
һавалан	V
мәчет	N
анданте	N
колынлат	V
Шснә	V
гозер	N
ландо	N
кирелән	V
нәфислә	V
исәнлек-саулык	N
дебаркадер	N
уңай	ADJ
гөбе	N
йомшарткыч	N
ырым-шырым	N
тулым	N
зат	N
лексикологик	ADJ
керешли	ADVV_NEG
техник	N
рәтлә	V
соңыннан	ADV
хәят	N
нәмә	ADJ
яссыла	V
бәйге	N
томагавк	N
Шскәрмә	N
сөремлә	V
легаль	ADJ
ләң-ләң	ADVV_NEG
рассада	N
чуен	N
гомер	N
мәсьүлият	N
кигәвен	N
уклад	N
Шлле	NUM
чыдам	ADJ
килендәш	N
ластик	N
биофизика	N
күзәт	V
чиста	ADJ
полимер	N
аптечка	N
мания	N
корсар	N
газүткәргеч	N
кинәнеч	N
формулировкала	V
серлелән	V
натурфилософия	N
тропик	ADJ
глюкоза	N
алыр-алмас	ADJ
тән	N
мәк	N
кинорепортаж	N
клика	N
сентябрь	N
ваба	N
Шртәнге	ADJ
җыентык	N
Шмгән	V
бемоль	N
берек	V
наянлан	V
кари	N
феминист	N
карабаир	N
жәллә	V
тугызла	V
оптика	N
кечерәй	V
сызгыч	N
мәзин	N
плюрализм	N
кисенте	N
диалектика	N
салынкы	ADJ
кайнат	V
анчар	N
гелиос	N
температура	N
символ	N
вибрация	N
плацкарт	N
база	N
сабыштыр	V
җепсә	N
картинг	N
шәмәхәлә	V
тугандаш	ADJ
кабат	ADVV_NEG
ярлы	N
хаос	N
тырылда	V
калтырча	N
пуфылда	V
сөзге	N
гадел	ADJ
механизация	N
куштырнаклар	N
түбә-түшәм	N
чутла	V
экспедицион	ADJ
канада	N
трагикомедия	N
Шндекс	N
мастерок	N
надзор	N
кое	N
үкер	V
чәке	V
формант	N
җинаятьчел	ADJ
коррупция	N
күмерлән	V
зурай	V
брамсель	N
кәк-күк	N
аргументла	V
котыр	V
чапылда	V
кысанлан	V
эпик	ADJ
геоморфологик	ADJ
идарәчел	ADJ
монпаси	N
Шкмәк	N
маньяк	N
шулер	N
җиләк	N
герой	N
Шшарәлә	V
бушай	V
калош	N
көзге	N
парабеллум	N
үзсүзле	ADJ
бә	N
денатурат	N
хәким	N
макинтош	N
реаль	ADJ
электромобиль	N
котлет	N
сәхәр	N
арала	V
үрдәк	N
кураре	N
хәп	PREF_ULTRA
шактый	PN
алтынсу	ADJ
турист	N
исти	ADJ
рудимент	N
кайра	V
роза	N
чың	N
һәлакәт	N
саргайт	V
ябалак	N
эгоистик	ADJ
хандра	N
бирле	HELP_VERB
солист	N
радиоаппаратура	N
Шслам	N
дивизион	N
миссия	N
сөйлә	V
дедуктив	ADJ
азарт	N
фут	N
транспарант	N
нәзарәт	N
йолкыш	ADJ
базар	N
лавр	N
деспотик	ADJ
работник	N
коллектор	N
узаман	N
сорбит	N
текәләт	V
ретроспектив	ADJ
кинодраматург	N
чәйнә	V
метан	N
фабрикант	N
халәт	N
парчалан	V
чупырда	V
боҗра	N
марш	N
элементар	ADJ
оперативка	N
традицион	ADJ
язмыш	N
тозлан	V
зерәгә	ADVV_NEG
кондырлы	ADJ
ирланд	N
таба	PN
мавр	N
страховка	N
шәмдәл	N
моңлан	V
чытлык	ADJ
якын	ADJ
тузгы	V
өстерт	V
этнолог	N
алдым-бирдем	ADJ
көренде	N
кашкарый	N
акбур	N
гомосексуализм	N
тукын	V
четердә	V
пыранла	V
көнҗет	N
тактика	N
өрдергеч	ADJ
асыл	N
яраттыр	V
сукно	N
бойкот	N
ябыл	V
ел	N
псевдоним	N
үчлә	V
майна	N
котай	V
теркәгеч	N
әвәс	N
кагай	V
радиология	N
юшкын	N
куала	V
минор	N
таксатор	N
туңкай	V
тыгызлан	V
суверен	ADJ
муен	N
түтәй	N
фракция	N
кибек	V
сионизм	N
разнарядка	N
киребеткән	ADJ
яраксызлан	V
ризыклан	V
комедиячел	ADJ
композиция	N
йөткерт	V
һәвәс	N
кор	V
кортка	N
чиркан	V
землемер	N
гороскоп	N
әһел	N
бор	N
троп	N
сәлперә	V
салицил	N
кәҗә	N
гарби	ADJ
тач	ADVV_NEG
катод	N
эшләнмә	N
кытыршылан	V
состав	N
чишмә	N
дым	N
империал	N
кый	V
тозак	N
ашкын	V
казино	N
шәрәлән	V
ярдәм	N
мелла	N
кабаттан	ADV
максимализм	N
текелдә	V
коллык	N
саилче	N
сүндергеч	N
приказчик	N
чыйкылда	V
җуй	V
тарттыр	V
ташла	V
бизәнү-ясану	N
выжылдат	V
вәземлә	V
брелок	N
ыгы-зыгылан	V
монотеизм	N
чәчрә	V
иртәсен	V
азган-тузган	ADJ
мыскыллат	V
каршыла	V
явыз	ADJ
аз	V
консервант	N
ятлан	V
әйтел	V
чапкы	N
башкатыргыч	ADJ
фалнамә	N
бразилияле	N
кавалерист	N
гайморит	N
җөмлә	N
синус	N
хронограф	N
прейскурант	V
коллективизм	N
күтәргеч	N
кич	V
кидер	V
папирус	N
Шнкыйлаб	N
корпорация	N
графомания	N
какшат	V
ялангачлан	V
папаха	N
капшагыч	ADJ
гербарийла	V
көяз	ADJ
кисмәк	N
арчы	V
гармония	N
аяксызлан	V
рада	N
ирсәк	ADJ
уткойрык	N
чират	N
автографик	N
күксә	V
шыелда	V
эсселән	V
стронций	N
Шзрә	V
баз	V
ятла	V
куер	V
баз	N
хәзергәчә	ADV
экономия	N
шәкли	ADJ
канал	N
коммуникацион	ADJ
чират	V
оял	V
примат	N
кисәү	N
хафа	N
шаркылда	V
азгын	N
шаңгырда	V
католикос	N
шепкән	N
помада	N
меңәрчә	ADV
көлтәлә	V
клоунада	N
кули	N
борчыт	V
скетч	N
чекрәй	V
боендырык	N
үзгәрт	V
логопед	N
аймыл	V
әдәпсезлән	V
аквариум	N
икра	N
земснаряд	N
казакин	N
контрактация	N
чабагач	N
мемориаль	ADJ
буклет	N
репетитор	N
гайбәт	N
тишел	V
патологик	ADJ
төркемлә	V
цунами	N
генералитет	N
вариациялә	V
планлаштыр	V
ревтрибунал	N
фәкыйрь	ADJ
бШе	V
червонец	N
цивилизациялә	V
карма	V
триумфаль	ADJ
масса	N
читсен	V
әгәр	CNJ
купшылан	V
бавар	N
яп	PREF_ULTRA
тахикардия	N
үлем	N
челтәрләт	V
кыяр	N
дыңгырдат	V
менеджер	N
чека	N
яшер	V
макта	V
чеканка	N
чирканыч	ADJ
массала	V
мордва	N
атлас	N
йончыткыч	ADJ
шарик	N
эврика	N
капылт	ADVV_NEG
өмә	N
бөтендөнья	ADJ
саран	N
кухня	N
күмәч	N
тоник	ADJ
модуль	N
лагерь	N
вокал	N
таркал	V
хуҗа	N
папирос	N
тезмә	N
җилд	N
ярат	V
сәләмәлән	V
дубликат	N
манты	N
татлы	ADJ
ганбәр	N
бау	N
дәрвШш	N
кәттә	ADJ
калын	ADJ
ватт	N
трактовка	N
смотр	N
ажиотаж	N
белер-белмәс	ADJ
экстравагант	ADJ
прелюдия	N
чатан	ADJ
интеллект	N
чабалан	V
вәхшШлә	V
наркомат	N
рәшәткәлә	V
чум	V
рампа	N
сугым	N
сагынычлы	ADJ
автопилот	N
шәригать	N
чум	N
калтырат	V
фамилиядәш	N
яшеллә	V
әл-хәл	N
акшарлан	V
тыкырда	V
өшәнчек	N
патетика	N
бәхилләт	V
сунар	N
кадакла	V
мышна	V
канатлан	V
картер	N
башкода	N
терелткеч	ADJ
субстантив	ADJ
әманәт	N
жуылдат	V
җәлпәк	ADJ
ботарлан	V
алшарт	ADJ
берәм-берәм	ADV
кармалан	V
бюст	N
инаныч	N
кыерсыт	V
карабодайчалар	N
имам	N
быргы	N
ана	N
карета	N
оккультизм	N
өфер	V
март	N
какыр	V
кирпеч	N
фидакарь	ADJ
кирт	V
травматология	N
глаукома	N
тояк	N
гильотина	N
тәпәлә	V
гаеп	N
сүрә	N
сахароза	N
күтәрел	V
дөп	PREF_ULTRA
мускус	N
карат	V
чуклы-чачаклы	ADJ
юләрсет	V
күперен	V
арена	N
орган	N
метрика	N
ансамбль	N
ясин	N
полюс	N
сводка	N
сыбызгы	N
бертуган	ADJ
комагайлан	V
тондыр	V
казан	N
чал	V
брошюрала	V
чүт	ADVV_NEG
автоколонна	N
казан	V
футурология	N
юк-бар	N
тәкәббер	ADJ
алдан	V
җепшеклән	V
эстафета	N
траншея	N
парикмахер	N
тупик	N
уздыр	V
ямат	V
аннан	ADVV_NEG
нейтрино	N
корвет	N
чабыштыр	V
килмешәк	N
ямансулат	V
әрдәнә	N
позитивизм	N
тереләй	ADV
медиаль	ADJ
тантана	N
регент	N
экс-президент	N
агитбригада	N
мундштук	N
абажур	N
юлдыр	V
талымла	V
а	N
бензонасос	N
чура	N
күрәләтә	ADV
консерватив	ADJ
чәбәкле	N
Шкенчел	ADJ
маяк	N
морф	N
кайгырт	V
өйлән	V
мәкалә	N
инвалид	N
градация	N
җәрәхәтлә	V
гадәт-йола	N
күпмешәр	PN
иртәме-соңмы	ADVV_NEG
нәмәхрәм	ADJ
фунт-стерлинг	N
метизация	N
шорник	N
кысла	N
күбеклән	V
этюд	N
стриптиз	N
артыш	N
мәһабәт	ADJ
битарафлан	V
пошаман	N
неон	N
чукмарбаш	N
васыять	N
көдрәш	ADJ
ныгыткыч	N
черки	N
какырык	N
ыругдаш	N
йодла	V
порошок	N
аңлашыл	V
пантера	N
үртәлән	V
абстракциялә	V
шөреплә	V
әче	ADJ
ыктымат	ADJ
чәчә	V
шашкын	ADJ
шәфкатьлән	V
тары	N
сенат	N
хасият	N
аткар	V
сахарин	N
косинус	N
хроника	N
ноль	N
соклан	V
параноик	N
кооперация	N
урманчык	N
буйла	V
сангвиник	N
үзалдына	ADV
бедуин	N
тонык	ADJ
мендәр	N
бүтән	ADJ
очкынла	V
пономарь	N
кимерчәк	N
хәшәрәт	N
чукын	V
гыжла	V
блокада	N
тыңлат	V
мөгезборын	N
шайтани	ADJ
ышык	ADJ
шашка	N
камиллән	V
багор	N
эчлә	V
йот	V
сбор	N
теп	PREF_ULTRA
җыр	N
аксыл	ADJ
йот	N
шШң	V
камертон	N
үгШ	N
җилембалык	N
шницель	N
нянька	N
таманла	V
чордаш	N
калтыравык	ADJ
мышьяк	N
җамаяк	N
амуниция	N
кнәз	N
трап	N
күтәрмә	N
форсат	N
марганец	N
кружка	N
малайсыт	V
җөп	ADJ
аллегорик	ADJ
пластмасс	ADJ
уңайла	V
җөйлән	V
пошлина	N
фреон	N
дөмбердәт	V
личинка	N
тәсбШх	N
Штальян	N
күперчек	N
концлагерь	N
һөнәр	N
тырмат	V
зерәгә	ADV
аңгыралат	V
шулхәтле	PN
сыкра	V
алюминий	N
плашкоут	N
канат	N
туф	N
абхаз	N
иркенлә	V
шәүләлән	V
элпе	N
селкенмәле	ADJ
эндокринология	N
инициатор	N
эвакуация	N
каудан	N
пикап	N
ыруг	N
чыпырда	V
канат	V
нам	N
яхшы	ADJ
шәрехлә	V
диссимиляция	N
кызыксын	V
кибәнлә	V
сакчыл	ADJ
венецияле	N
радиостудия	N
пулемет	N
чемет	V
тарткы	N
нәсыйхәт	N
ыргакла	V
билингвизм	N
немецчала	V
гакыл	N
гырла	V
тукан	N
заговор	N
шыртлавык	N
чартлат	V
мәклә	V
сырышкак	ADJ
кнопкала	V
юырт	V
рекорд	N
өтер	N
шторм	N
так	V
төркилек	N
әйбер	N
кресло	N
зынҗырла	V
матурлан	V
онкология	N
автолавка	N
ургыл	V
узгынчы	N
фанерла	V
шытырдавык	N
сигара	N
анализ	N
дәлаләт	N
урып-җыю	N
конструктив	ADJ
Шдеолог	N
чыр-чу	N
антикисәкчек	N
мәзәк	N
процесс	N
тоталь	ADJ
колонизация	N
астар	N
яңачалык	N
тезлән	V
дәрес	N
Шслән	V
түшкә	N
дәрт	N
фронтовик	N
багындыр	V
редакция	N
бөркәнчек	N
никрут	N
булдыксыз	ADJ
тышаула	V
Шртәсен	V
исәрен	V
катлам	N
куштыр	V
борынчыкла	V
процент	N
тазарын	V
каер	V
катлан	V
сауна	N
килешен	V
искитмәле	ADVV_NEG
җимер	V
филолог	N
күбе	N
гипс	N
порция	N
звено	N
мисырлы	N
ураза	N
форзац	N
тормоз	N
сыворотка	N
әҗәт	N
әдәплелән	V
аналогия	N
сидек	N
казус	N
тынчу	ADJ
юынты	N
тәһарәтлән	V
абын	V
ликвидация	N
бөккән	N
үпкә	N
юла	V
барон	N
ятым	N
каезлан	V
ферма	N
меласса	N
тубырлан	V
егетлән	V
ахмак	N
кросс	N
келәймә	N
помадка	N
ихлас	ADJ
баржа	N
экипировка	N
газаплан	V
замазка	N
тирада	N
бәйләм	N
фармакология	N
аннал	N
теркелдә	V
рядовой	N
регрессив	ADJ
түгәрәк	N
бәргәлә	V
электромеханик	ADJ
өркет	V
по	N
жандармерия	N
яд	N
мөнәсәбәттәш	N
тимерлән	V
әйбәтлә	V
ал	PN
фрау	N
чайпал	V
матбугат	N
психоневрология	N
браунинг	N
ишиас	N
флегматик	N
структура	N
ныклы	ADJ
карлыгач	N
кабын	V
канунла	V
клоун	N
барырдай	ADV
турыпочмаклы	ADJ
патриархаль	ADJ
броняла	V
моногамия	N
сырпалан	V
полемика	N
йөр	V
открытка	N
китерел	V
безелдек	N
авансцена	N
солидар	ADJ
коңгыртлан	V
чымырда	V
футуризм	N
турыпочмаклык	N
кодрәт	N
конституция	N
эскимос	N
симулянт	N
насыйп	N
гадәттәге	ADJ
соргылт	ADJ
ширбәтлә	V
реклама	N
депрессив	ADJ
пленар	ADJ
чәбәк-чәбәк	N
чем-кара	ADJ
глобулин	N
сул	ADJ
пиктограмма	N
шыпырда	V
куак	N
кыңгырайт	V
наиб	N
алачык	N
мәҗбүри	ADJ
университет	N
төя	V
касмаклан	V
кожан	N
иярмә	N
амбар	N
үләнчел	ADJ
колит	N
кисап	N
мануфактура	N
экспансив	ADJ
шеф	N
тишек-тошык	N
куст	N
чШтлә	V
табанча	N
кичәй	V
кәйләлә	V
ют	N
гидрат	N
революционер	N
коммивояжер	N
булырдай	ADVV_NEG
үтүклән	V
стимул	N
боҗралан	V
атом	ADJ
факыр	N
сый-хөрмәт	N
гимназист	N
гөнаһ	N
аңла	V
зольмәт	N
сиккатив	ADJ
кымыз	N
диверсион	ADJ
кубанка	N
оранжерея	N
чокырай	V
иммигрант	N
валет	N
маякла	V
кон	N
дельфинарий	N
алмаш-тилмәш	ADV
мумиялә	V
сусар	N
кечкенә	ADJ
берет	N
чүпрә	N
лапылдат	V
фурункул	N
патолог	N
симфония	N
комсыз	ADJ
тренажер	N
камыт	N
имажинист	N
матди	ADJ
чикмән	N
политбюро	N
санскрит	N
украинчала	V
тырмалан	V
Шпподром	N
көленеч	ADJ
мәһәр	N
кайгыр	V
истихарә	N
матрешка	N
сөяклән	V
физиолог	N
буйча	N
чуал	V
ясле	N
чалышайт	V
фаворит	N
кода	N
тармакла	V
үрелмә	N
маркизет	N
нахак	ADJ
ассамблея	N
антиклерикаль	ADJ
газәл	N
тиски	N
лорд	N
каюла	V
ардакла	V
шинель	N
гарип-гораба	N
сыйнфый	ADJ
реальлә	V
кабиләдәш	ADJ
сихер	N
рентабель	ADJ
кадим	ADJ
маңкала	V
дантист	N
тираж	N
ояла	V
чемердә	V
тилемсә	ADJ
толстовка	N
той	V
аналогик	ADJ
мәшри	N
тукмакбаш	N
популяция	N
китап	N
кыргыйлан	V
исемлән	V
колба	N
җизнәкәй	N
нейтральлә	V
багаж	N
бирчәй	V
укала	V
аптекарь	N
протеин	N
штоф	N
җилсет	V
корылай	ADV
ядрә	N
татуировкала	V
бает	V
миләүшә	N
үстер	V
шәхсият	N
авитаминоз	N
билгеләвеч	N
сузыл	V
рецептор	N
япь	N
яңгырла	V
финплан	N
тазала	V
фишка	N
болагай	ADJ
чарасызлык	N
лингвистика	N
җилбердә	V
селекционер	N
буяк	N
электрокардиография	N
туплан	V
кылыйлан	V
отыры	ADVV_NEG
утилизациялә	V
гипертоник	ADJ
пудрала	V
сатир	N
кубизм	N
төшке	ADJ
хәрчәүнә	N
чүкечбаш	N
егет	N
былтырга	ADV
фотоо	N
концепция	N
феноменаль	ADJ
акционер	N
компакт	N
ышанмастай	ADVV_NEG
киңәй	V
атеросклероз	N
ике	NUM
тәмамлан	V
винчестер	N
каһәрлән	V
чалдон	N
метастаз	N
дәвалат	V
йок	V
ата	V
телсез-чукрак	ADJ
радист	N
өлкән	ADJ
юксыл	ADJ
диктатор	N
тәгаенлек	N
арттыр	V
дагстанлы	N
куен	N
эстакада	N
Шпотека	N
юксын	V
рас	ADJ
гамәли	ADJ
бассейн	N
микрокосм	N
ата	N
документаль	ADJ
янар	ADJ
күчерт	V
шапырдат	V
дәрмана	N
милитаризация	N
чыжылдат	V
шарманка	N
киртәләт	V
радиограмма	N
пассив	N
һәйбәт	ADJ
лицензия	N
пограничник	N
колонизациялә	V
кайтаваз	N
ялантән	ADJ
ашкынулы	ADJ
штаб-квартира	N
булышлык	N
колоссаль	ADJ
караңгы	ADJ
угро-фин	ADJ
булмастай	ADJ
протест	N
быел	ADV
вакцина	N
лычма	N
ута	V
ишарә	N
аерча	N
колан	N
яшерт	V
юнәйт	V
тайчан	V
төгәллән	V
тегермән	N
жираф	N
әфәнде	N
исправник	N
терәгеч	N
янә	ADV
чалу	N
контральто	N
бунчук	N
язма	N
адәми	ADJ
тартар	N
динамометр	N
киптергеч	N
мальва	N
җөмһүрият	N
кушым	N
скептицизм	N
уйнаклат	V
тиңлән	V
вәләкин	CNJ
серб	N
беркавым	ADVV_NEG
сөрткеч	N
мотлак	ADJ
җәүһәрлән	V
тәкрарлан	V
сантыйлан	V
журнал	N
акшарла	V
космогоник	ADJ
линза	N
әбәк-чәбәк	N
дата	N
реставрациялән	V
арау	N
вице-адмирал	N
утилизация	N
ишегалды	PN
арыслан	N
монашка	N
сакаулык	N
фурия	N
кашка	N
шеврон	N
тәмуг	N
рулон	N
Шртәсе	ADV
ихата	N
менингит	N
портупея	N
плата	N
амплуа	N
тулынкы	ADJ
шан-шөһрәт	N
киңәш-табыш	N
төкләч	ADJ
ашуг	N
экваториаль	ADJ
затон	N
мелиоратив	ADJ
орнаментла	V
думбра	N
резюме	N
тутакай	N
икеле-микеле	ADJ
буффон	N
чышылда	V
тирмә	N
йорт-җиһаз	N
редукциялә	V
аллерголог	N
әкренәйт	V
юләр	N
газификация	N
карточка	N
күбәүлә	V
гарпун	N
ыгы-зыгы	N
циклик	ADJ
гистология	N
экспедитор	N
статуя	N
хәрәкә	N
комсорг	N
повесть	N
слет	N
эчтәлек	N
билән	V
теләкә	N
хәтле	POST
күнек	V
гимназия	N
ачәрвах	N
бишәүләшеп	ADV
каплан	N
маневрла	V
баобаб	N
балдак	N
дыңгырдавык	ADJ
ихсан	N
тукыт	V
поп	N
карлан	V
турылан	V
бульвар	N
гипербола	N
ислән	V
акр	N
беседка	N
антидемократик	ADJ
гримлан	V
замана	N
солдафон	N
кырын	V
катетер	N
масштабла	V
ассигнация	N
гувернант	N
кайтышлый	ADV
салфетка	N
йодрык	N
ринология	N
беләүлән	V
кадер-гыйззәт	N
көлбикә	N
сыйфатла	V
хәлвә	N
каталог	N
төплә	V
витамин	N
доңгырда	V
кыршау	N
фундук	N
үткән	ADJ
планерка	N
миһербан	N
өйрәтмә	N
халык	N
ару	ADJ
дөрлә	V
тарат	V
уңайсызла	V
чүпрәлән	V
трусик	N
трилогия	N
саклан	V
йортла	V
зинһарлап	ADV
өянәк	N
кабахәт	N
өйрә	N
теократия	N
азия	N
хәзергә	ADV
эмбриолог	N
манси	N
тралла	V
каплама	N
җитенке	ADJ
аорта	N
мәсхәрәлән	V
стандартлаштыр	V
тарык	V
гыйбрәт	N
авангард	N
ургыч	N
груһ	N
куан	V
бәһа	N
толстойчылык	N
очрашу	N
әдәбШ	ADJ
ямьсезлән	V
поход	N
Шскәрт	V
нәркиз	N
циник	ADJ
үзбаш	ADVV_NEG
микроорганизм	N
борей	N
литография	N
аш	N
көчлән	V
мастика	N
качкалак	ADJ
аш	V
фитрәт	N
күр	V
ташкын	N
айны	V
шагыйранә	ADV
кушма	ADJ
кетон	N
баткак	N
боргыч	N
хөрмәтлән	V
көйрәт	V
репродукция	N
ялман	V
өләшен	V
бәхәслә	V
патриотик	ADJ
дифференциал	N
ализарин	N
латекс	N
кожух	N
берилл	N
лесничий	N
охшаш	ADJ
майбалык	N
башак	N
академизм	N
гыйнвар	N
карындык	N
кәүсәр	N
марганцовка	N
кодала	V
фотокарточка	N
элгәр	N
оеш	V
идиллия	N
эләк	V
сортла	V
газ	N
гитара	N
ШблШс	N
Шртәдән	ADVV_NEG
косметолог	N
гравий	N
бытырда	V
зирәк	ADJ
чемчен	V
уҗым	N
пикадор	N
вакытлыча	ADV
госманлы	ADJ
бай	N
иртән-иртүк	ADVV_NEG
рюкзак	N
эрзац	N
кун	V
кыйбатлан	V
орфограмма	N
кориандр	N
стабилизатор	N
төй	V
практикант	N
стандарт	N
куркаклан	V
тальян	N
хатирә	N
имтеклә	V
вибратор	N
патетик	ADJ
форпост	N
Шгумен	N
сәхнә	N
шкала	N
чагылдыргыч	N
кодеин	N
кәсә	N
шыңшы	V
кабырчык	N
пуловер	N
черемә	N
җәяүләт	V
нефть	N
зират	N
алмагач	N
күптөрле	ADJ
магнитола	N
хризолит	N
богау	N
төнозын	ADVV_NEG
фольклор	N
чукрак	ADJ
җәй	N
норд-ост	N
чәпә	V
калька	N
олтан	N
алалан	V
дымсу	ADJ
Шлт	V
бертигез	ADJ
урбанизация	N
укыту-агарту	N
алып	N
тукландыргыч	ADJ
оксидла	V
җәй	V
конструкциялә	V
капризлан	V
ветчина	N
өстерәлчек	N
бөтер	V
чүмәш	V
декорация	N
дактилоскопия	N
толыкман	N
чүплән	V
граждан	N
бензоколонка	N
публика	N
артык	ADJ
көнлекләп	ADV
бомбардир	N
экспонометр	N
юхала	V
транслитерация	N
таныклама	N
Шртәдән	ADV
җиткән	ADJ
хода	N
трюм	N
тембр	N
балабан	N
чукыр	N
сюита	N
кыздыр	V
ялангач	ADJ
варикоз	N
мехла	V
күтәмә	N
ярылан	V
китер	V
муенчык	N
семиотик	ADJ
скиф	N
спортзал	N
филтә	N
сугар	V
базальт	N
газовик	N
кыенла	V
тапагыч	N
медсестра	N
әлҗе-мөлҗе	ADJ
абзац	N
редукция	N
кирка	N
яран	N
каюта	N
мырла	V
тукылда	V
умырт	V
растрата	N
килбәт	N
буржуазия	N
утызмеңче	N
потханә	N
җитмеш	NUM
графа	N
икейөзле	ADJ
алтын	N
җелек	N
интриган	N
кирәк	V
чыныктыр	V
пешерел	V
җиткерел	V
райондаш	N
дүртьяклы	ADJ
башкисәр	N
очкыр	ADJ
беркая	ADV
хаотик	ADJ
арадаш	N
дула	V
десант	N
мародер	N
бервакытны	ADVV_NEG
бәһә	N
шыпылда	V
аклан	V
авторитет	N
бегемот	N
үҗәтлән	V
кайчагында	ADVV_NEG
тШз	ADJ
зенитка	N
гаҗәплән	V
патриот	N
чана	N
яздыр	V
пирамидон	N
хант	N
шәплән	V
хөкем	N
бермәл	ADVV_NEG
инстанция	N
эпистоляр	ADJ
штат	N
коалицион	ADJ
метрдотель	N
пергамент	N
штатский	ADJ
куна	N
Штәк	N
пычкы	N
идеалистик	ADJ
берүзе	N
сирәгәй	V
куырган	ADJ
тригонометрия	N
семит	N
шәкерт	N
шәүвәл	N
гигант	N
целлофан	N
милиционер	N
сына	V
тиктомалдан	ADV
банкет	N
урамбаш	N
легион	N
плавки	N
сикәлтә	N
канлан	V
әтәчлән	V
тудыр	V
шымчы	N
натр	N
даирә	N
уфыр	V
авынкы	ADJ
кыйрат	V
староста	N
очырт	V
дүрткеллә	V
силлабо-тоник	ADJ
алабай	N
төймә	N
проректор	N
классификатор	N
стереотип	N
зеңгелдә	V
төрара	ADJ
македонлы	N
монополия	N
мылтык	N
зерелдә	V
кәпәр	V
калган-поскан	ADJ
байтирәк	N
кырын-ярын	ADV
лаконизм	N
үрем	N
Шшарәт	N
әлсерә	V
булыр-булмас	ADJ
агитпоезд	N
дерматит	N
дума	N
радиолокация	N
балавызлан	V
рәхәт	ADJ
плеяда	N
беркөн	ADVV_NEG
Штлә	V
котсызлан	V
кер	N
үгет-нәсихәт	N
яшәт	V
дезертир	N
тиф	N
болагайлык	N
ординар	ADJ
акай-чукай	ADJ
асрама	N
эрзя	N
аргумент	N
гетман	N
штрих	N
рШзык	N
шыпырт	ADVV_NEG
парадный	ADJ
кер	V
мәми	N
тормозла	V
чирәп	N
берьеллык	ADJ
җәйрә	V
контрапункт	N
соклангыч	ADJ
чадра	N
хәзерлә	V
кома	N
өндәмә	N
киносценарист	N
шыкырдат	V
готовальня	N
таркат	V
бармен	N
толып	N
серле	ADJ
ыс	N
чык	V
каракалпак	N
бөҗәк	N
архив	N
чык	N
полис	N
тупчы	V
норвегияле	N
ач	V
жюри	N
коймала	V
язгыч	N
индустриаль	ADJ
коңгылда	V
минералла	V
дәхил	N
альбинос	N
гыйбадәтханә	N
ангина	N
әбекәй	N
каравылла	V
тартыл	V
метро	N
ялт	ADV
кеше-фәлән	N
капор	N
нептун	N
кәнәфи	N
ассимиляция	N
кесә	N
мари	N
антрацит	N
басымчак	ADJ
окулист	N
лава	N
тукранбаш	N
сөт-катык	N
хәтфә	N
шәһәрара	ADJ
миңгерәйт	V
аллергия	N
балкыт	V
Шртәгәге	ADJ
сорау	N
Шркәлә	V
нототения	N
вәсвәсәлә	V
буйлатып	ADVV_NEG
ое	V
мегафон	N
һау-һаула	V
тамырлан	V
наместник	N
дрель	N
конфиденциаль	ADJ
калибрлан	V
версия	N
фургон	N
берәм-берәм	ADVV_NEG
дизель-мотор	N
вклад	N
феминизация	N
фабрика	N
патология	N
шпатель	N
шлагбаум	N
аванпост	N
тирә-як	N
үпкәчел	ADJ
конус	N
тышлан	V
глобаль	ADJ
изолятор	N
репрессиялә	V
садәлә	V
төзек	ADJ
минераль	ADJ
каенсеңел	N
фармацевтика	N
ферментла	V
әнчеклә	V
кинореклама	N
күзек	V
җирсен	V
секунд	N
бака	N
алкоголизм	N
кыштырдавык	ADJ
арыклан	V
ямансы	ADV
хәчтерүш	N
прима	N
оборона	N
анысы-монысы	PN
виртуоз	N
блокадала	V
пошкырт	V
лексиколог	ADJ
кунсткамера	N
сөлек	N
буйвол	N
мазала	V
райвоенкомат	N
пошын	V
предприниматель	N
шевиот	N
хайван	N
визала	V
келт	ADV
тыкрык	N
шифрла	V
аграр	ADJ
балетмейстер	N
дөбердә	V
рудник	N
кирза	ADJ
эфир	N
келәнче	N
дөңгелдә	V
котычкыч	ADJ
роман	N
түн	V
каторга	N
ышна	N
импотент	N
депозит	N
конденсация	N
заманчалык	N
көрпә	N
тоҗым	N
гиацинт	N
гравитация	N
чәбәклә	V
вәхши	ADJ
оптимист	N
аязлан	V
пульверизатор	N
талчык	V
йөзьеллык	N
үткерлә	V
эвкалипт	N
баг	N
мышнат	V
ашык	V
бирем	N
колгасар	ADJ
оттиск	N
чиккән	ADJ
иннек	N
да	CNJ
ислах	N
тырыша-тырмаша	ADVV_NEG
җанлан	V
хасиятлә	V
чара	N
юешлән	V
чандырлан	V
җор	ADJ
кайгыла	V
бирән	N
әбәклә	V
ботарла	V
тапшырыл	V
пинг-понг	N
аңлатыл	V
кигер	V
стилист	N
судак	N
җиңеләйт	V
лазурь	N
сатин	N
квартирант	N
мут	ADJ
лимон	N
иркәләт	V
начальник	N
кантон	N
болгари	ADJ
кагылгысыз	ADJ
ният	N
вәкарь	N
чечен	N
экономист	N
такмакла	V
сынат	V
обломовчылык	N
селкен	V
хуҗалыкчы	N
фуфайка	N
трофей	N
беркайчан	ADVV_NEG
Шсем	N
чыптала	V
грейпфрут	N
брокер	N
канәгать	ADJ
җыпкы	N
капитализм	N
иганә	N
турник	N
кыекла	V
төзәй	V
холера	N
экспериментатор	N
коллективла	V
буар	ADJ
этнограф	N
йоклар-йокламас	ADJ
пылесос	N
терапия	N
акробат	N
җәлпәйт	V
ишәк	N
Шмла	N
куль	N
шәһәрчәлек	N
дәрья	N
сынык	ADJ
теге	PN
гаеплән	V
йомарлам	N
искәр	V
аркылы-торкылы	ADJ
ошбу	PN
павиан	N
зә	N
номенклатура	N
фриц	N
фланг	N
үпкәлә	V
соргылт-кара	ADJ
корылтай	N
ягуар	N
концерт	N
ботаклан	V
сау-сәламәт	ADJ
профиль	N
циркач	N
катыш-котыш	N
беллетристика	N
прШнц	N
би	N
риторика	N
фурор	N
шарлат	V
кыскаручан	ADJ
парламент	N
сагала	V
уян	V
кыркылда	V
диктат	N
коткы	N
фырла	V
батат	N
территория	N
өй	N
фасад	N
миф	N
сервант	N
шнурлан	V
уң	ADJ
рационализация	N
болтла	V
өлгерт	V
Шзолятор	N
иртүк	ADVV_NEG
бикләт	V
математик	N
бәгырь	N
милләттәш	N
кузалак	N
фигыль	N
сифилис	N
эллин	N
дальтоник	N
колхоздаш	N
шахмат	N
тинтерә	V
гаскәр	N
страховкала	V
әхлаксызлан	V
риваять	N
ромштекс	N
трико	N
лач	ADVV_NEG
протектор	N
тустыр	V
шытырда	V
әшәкелә	V
алда	V
кырыгалдар	N
медик	N
ринг	N
бекон	N
кавын	N
күл	N
кыланмыш	N
фонетика	N
метеорология	N
сайла	V
сеанс	N
доктрина	N
бизәнү-төзәнү	N
тарихилык	N
атака	N
дисгармония	N
чөй	N
һөнәрмәнд	N
киштә	N
тавышла	V
күппочмак	N
аспирин	N
катнашма	V
яңакла	V
тукмаклан	V
әләкчел	ADJ
арбитр	N
чәй	N
катнашма	N
кәкрелек	N
якынайт	V
облава	N
карай	V
пигментла	V
практика	N
чөй	V
турне	N
комырык	N
офсет	N
мыжгылда	V
ышкы	V
полемист	N
пуант	N
дәүләтләштер	V
кыргыз	N
бура	V
җилкәлә	V
пульсация	N
бона	N
аспирант	N
бура	N
италияле	N
баштарак	ADV
чатнаган	ADJ
гвардия	N
ышкы	N
хәрби	ADJ
депо	N
тыңкышлан	V
ялгам	N
милитар	ADJ
парафин	N
мәрсин	N
дирекция	N
норма	N
ык-мыкла	V
сигнализация	N
тупый	ADJ
шиң	V
географик	ADJ
кылан	V
буынтык	N
пацифист	N
аулакла	V
Шсер	V
быелга	ADV
фотопластинка	N
маммология	N
Шркенлек	N
картография	N
төзәтмә	N
силос	N
метафорик	ADJ
өлтерә	V
пожымла	V
сыегайт	V
фруктоза	N
төрпе	N
черек	ADJ
болгаткыч	N
сайгак	N
кешнә	V
кинооператор	N
анакай	N
электрла	V
камфора	N
Шш	N
автол	N
до	N
өндә	V
томалат	V
манера	N
неореализм	N
кызылбаш	N
гомосексуалист	N
штабельлә	V
Шш	V
барла	V
фашистик	ADJ
максима	N
проблематика	N
тавышлан	V
тупас	ADJ
гаугала	V
удар	N
ясалма	ADJ
утлык	V
эндокринолог	N
эквивалент	N
таксация	N
күтәр	V
Шркен	ADJ
каркасла	V
савык	V
шу	PN
песилән	V
шоколад	N
жокей	N
отпор	N
катмар	N
җыер	V
исәп	N
йолкын	V
озын	ADJ
персонал	N
фонетик	ADJ
арыл	V
карта	N
миокардит	N
мөгаллим	N
мәсәл	N
кыргыз-каза	N
фотокәгазь	N
беленер-беленмәс	ADJ
корым	N
коршаула	V
пони	N
уралма	ADJ
ахылда	V
аффектация	N
көрәнсу	ADJ
гөнаһ-мазар	N
тәмле-татлы	ADJ
тукылдат	V
җияк	N
аквамарин	N
чит-чите	N
җот	N
тапчан	N
фотовитрина	N
фай	N
ухылда	V
ярымутрау	N
чыңла	V
шартлавык	N
нәзеклә	V
шихта	N
минбеләмлек	N
арчи	N
кадриль	N
фигаро	N
җете	ADJ
ботлы-чатлы	ADJ
җәя	N
радикаль	ADJ
күптезмәле	ADJ
истәлек	N
пирамидаль	ADJ
контролер	N
йомгакчык	N
медикамент	N
олигарх	N
кыштыр-кыштыр	ADVV_NEG
шома	ADJ
вермишель	N
лышкылда	V
ассортимент	N
черкелдә	V
күгәл	N
төзәнү-ясану	N
йол	V
ил-ат	N
үзгәлә	V
әткә	N
сагынмаклык	N
сигезьеллык	ADJ
чүпләт	V
тюлень	N
иҗек	N
азартлан	V
редиска	N
космик	ADJ
символика	N
хәбәрлә	V
тиктомалга	ADV
полигамия	N
дак	N
унитар	ADJ
склероз	N
төрдәш	ADJ
сатлык	ADJ
иркә	ADJ
зырылда	V
күчерел	V
лояль	ADJ
берләшкән	ADJ
хәбәр-хәтер	N
бронхоскопия	N
моназара	N
яньчек	ADJ
мускул	N
конкурент	N
һиндстанлы	N
скульптура	N
матурай	V
тилчә	N
сельпо	N
чумар	N
әйбәтләт	V
явым-төшем	N
алак-ялак	ADV
окрошка	N
краб	N
текст	N
юнкер	N
чуллык	N
кода-кодагыйлык	N
тибәр	V
хозур	N
хорафатчыл	ADJ
гади	ADJ
аппаратура	N
будка	N
хирыс	ADJ
беркатлы	ADJ
барлат	V
читән	N
маза	N
шхуна	N
суган	N
терморегулятор	N
өсләт	V
ватанчыл	ADJ
колхозла	V
саташкан	ADJ
сүз	N
ундүрт	NUM
биана	N
игәүлә	V
перифраз	N
технологик	ADJ
беркатлылан	V
текстиль	N
мөһим	ADJ
Шнәл	V
бимазалан	V
тынычсызла	V
комикс	N
бумази	N
тамыразык	N
багстан	N
тепловоз	N
робагый	N
адреналин	N
өйлә	N
ялкау	ADJ
цинизм	N
бордюр	N
каникул	N
җилкен	V
снайпер	N
муфта	N
гөлҗимеш	N
локальлә	V
номинация	N
промкомбинат	N
хәлсезлән	V
комбед	N
тарла	V
уравыч	ADV
посын	V
кило	N
турникет	N
канәгатьләндер	V
төпләт	V
тетмә	N
каенага	N
сыендыр	V
калку	ADJ
мотоцикл	N
түбәнтен	ADV
иран	N
тиктомалга	ADVV_NEG
ихтыяҗ	N
арулан	V
төрлән	V
мүкәлә	V
санла	V
гну	N
куллама	N
джут	N
гараж	N
декольте	N
радиоузел	N
вакыйга	N
циркуль	N
беркөн	ADV
бушаткыч	N
терсәклән	V
Шсәп	N
урак	N
текмә	N
гримла	V
этнографик	ADJ
навигация	N
аттестация	N
китәр	V
иртәгә-берсекөнгә	ADVV_NEG
бактериологик	ADJ
зирек	N
чүмәлә	N
төчкелтем	ADJ
дистиллятор	N
әнчек	N
гепатит	N
шаккатыр	V
ирреаль	ADJ
күралма	V
телгеч	N
шартла	V
коллоквиум	N
макрогаләм	N
мопс	N
мөлаемлан	V
үткәр	V
креветка	N
секрет	N
тужурка	N
башлам	N
эксплуатациялә	V
сыер	N
кыяк	N
парад	N
кантарлан	V
фразеологизм	N
тары	V
бәяләмә	N
маразм	N
атавизм	N
җикән	N
шашын	V
кануният	N
кәбен	N
углеводород	N
бизәклә	V
унарла	V
библиофил	N
курлык	N
кассир	N
юкар	V
романтиклаштыр	V
төклән	V
үкенеч	N
төрлечәлек	N
шпиль	N
тетрәндер	V
сирпел	V
шәхсән	ADVV_NEG
пролог	N
Шртәге	ADJ
бәрабәр	ADJ
пылау	N
галерка	N
хөҗрә	N
корай	V
чүбек	N
тенденциоз	ADJ
кыбырсы	V
стенографистка	N
нәфрәтлән	V
сырхаула	V
тырмала	V
центрист	N
гакыйбәт	N
чемпион	N
демонстрант	N
германофил	N
замазкала	V
ки	V
рафинадла	V
суыксу	N
шырпыла	V
базис	N
ашлы-сулы	ADJ
самовар	N
ару-талу	N
аткы	N
невролог	N
аңлатма	N
фарфор	N
яла	V
штопор	N
интим	ADJ
сорыкорт	N
башсызлан	V
ботаника	N
яла	N
примадонна	N
банк	N
үкен	V
кешән	N
семинарист	N
иләклә	V
шималь	N
бия	N
шофер	N
нәхү	N
трансмиссия	N
калпак	N
күпме	PN
очрат	V
бие	V
ген	N
күңелләт	V
кубатура	N
гомумдәүләт	ADJ
финт	N
ташлама	N
мушкетер	N
агрономик	ADJ
магистратура	N
бульдозер	N
мыркылдавык	N
башаяк	N
рецепт	N
мәкальлә	V
шыпыртлап	ADV
каприз	N
шаһинә	N
постоялый	ADJ
камка	N
мавыктыргыч	ADJ
кыстыбый	N
кемлек	N
танцмейстер	N
куандыр	V
кырулы	ADJ
санаторий	N
бермәл	ADV
сасыт	V
компресс	N
мичман	N
телдәр	ADJ
лупа	N
пропорциональ	ADJ
договор	N
учет	N
Шман	N
кабаклан	V
тупланма	N
бәрәнлә	V
гүбән	ADJ
Шл-ана	N
ахаклан	V
кызар	V
кабым	N
йөрәксен	V
кунак-төшем	N
сенатор	N
контингент	N
броня	N
хоккей	N
натрий	N
хәлфә	N
пьедестал	N
арыш	N
гарьлән	V
ил-җир	N
түшәк-мендәр	N
келтер-келтер	ADVV_NEG
имчәк	N
информацион	ADJ
оркестр	N
өлеш	N
пансионат	N
агу	N
метрла	V
лаклат	V
аншлаг	N
зыңгырда	V
мораторий	N
канәгатьсезлән	V
ырмаула	V
тынгы	N
Шңгә-Шң	ADV
онлат	V
элемтә	N
өчьяклы	ADJ
реакционер	N
элегия	N
духовка	N
конференц-зал	N
түл	N
әтрәк	ADJ
шәһит	N
тукмал	V
баштанаяк	ADV
үтлә	V
метафора	N
лач	ADV
революционла	V
дивар	N
бормашина	N
рационализатор	N
өстерә	V
фоторепортер	N
Шт	V
информант	N
такырай	V
әүлия	N
дедерон	N
артикуляция	N
блузка	N
астыртын	ADJ
әби-сәби	N
суфизм	N
иприт	N
Шт	N
күкерт	N
хырылда	V
азап	N
клептомания	N
сырлы-мырлы	ADJ
венерик	ADJ
исерек	N
инспекция	N
кыңгыраула	V
флокс	N
галанка	N
шултикле	PN
тәлгәш	N
нарзан	N
әкренләт	V
энә	N
игез	ADJ
бу	N
тоташ	ADJ
биохимик	N
ондатра	N
уния	N
сумбур	N
киртә	N
кулинария	N
кардан	N
унтер-офицер	N
хәйрия	N
катмарлан	V
мондагы	ADJ
тыйнаксызлан	V
историографик	ADJ
бу	V
колода	N
вәхшәт	N
телевизион	ADJ
сигез	NUM
саботаж	N
көдрәй	V
археография	N
шелтәлә	V
кассовый	ADJ
йоклат	V
кә	N
чокырлы-чакырлы	ADJ
шарчык	N
татар-башкорт	N
габид	N
хедер	N
чикылдат	V
идеолог	N
педагогия	N
сын	V
графиня	N
эклектизм	N
кагыштыр	V
эшкәрт	V
ачыт	V
ришвәт	N
неоплатонизм	N
зональ	ADJ
рельеф	N
суырт	V
шифон	N
төртмә	ADJ
контракт	N
тарал	V
томат	N
сын	N
дертлә	V
кияү	N
урду	N
ачыргалан	V
кыш	N
грамм	N
Шрмәк	ADJ
исәнкерә	V
стенгазета	N
труба	N
черем	N
коралсызлан	V
ономастика	N
мергель	N
спартакиада	N
хисап	N
дәүләтара	ADJ
каһәр	N
беравыздан	ADV
талан	V
агротехник	ADJ
нәрсә	PN
ис-көч	N
клан	N
умрау	N
ролик	N
моң-зар	N
розетка	N
орлыклан	V
борт	N
әйрән	N
юләрлән	V
бетем	N
юн	V
лаос	N
Шшкеч	N
фараз	N
визуаль	ADJ
әчкелт	ADJ
келт	ADVV_NEG
экстракт	N
бозгын	N
облигация	N
сукырайт	V
титрла	V
фаси	ADJ
аппендицит	N
чатырдат	V
бикә	N
сөян	N
фонотека	N
тимгел	N
шанс	N
тоек	N
термин	N
стратегия	N
кайчак	ADVV_NEG
диваналан	V
алача	N
феникс	N
аныклык	N
административ	ADJ
көрчек	N
спидометр	N
битлә	V
мантыйк	N
җылын	V
чүәк	N
кооператор	N
остар	V
булырдай	ADV
кәбестә	N
комагай	ADJ
камердинер	N
станок	N
провизор	N
сосиска	N
өйрән	V
дистилляция	N
кабакча	N
гейзерит	N
никахлан	V
сыйфат	N
чылбыр	N
траулер	N
эмиссар	N
оогамия	N
сикермә	N
кибет	N
угала	V
графика	N
кытай	N
техничка	N
укра	N
нонсенс	N
тәпилә	V
Шзах	N
момент	N
моң	N
компаньон	N
негр	N
дипломат	N
чагым	N
ачы	ADJ
фарсизм	N
коляда	N
трансценденталь	ADJ
кып	PREF_ULTRA
балитәк	N
укымыш	N
кәмәл	N
киртеклән	V
нейрохирург	N
кыен	ADJ
хәбәрсез-нисез	ADV
мияула	V
шык	N
кимерт	V
кооперативла	V
эшкуар	N
урык-сурык	ADV
күрер-күрмәс	ADJ
тоткавыл	N
кизән	V
сәүдә	N
бизәт	V
медалист	N
кишәрлек	N
олан	N
пневматика	N
төшерт	V
фильтр	N
фидаи	ADJ
ары	ADJ
поезд	N
каенагай	N
икона	N
сазаган	ADJ
линотип	N
куян	N
кашыгаяк	N
реферат	N
тә	CNJ
реляция	N
янәшә-тирә	N
күптомлы	ADJ
канистр	N
спорт	N
галактик	ADJ
урат	V
юмореска	N
экспансионистик	ADJ
волость	N
карабаш	N
синоним	N
тапкырла	V
кинематика	N
иттифакла	V
тылсымла	V
илаһият	N
лагун	N
гипнотизм	N
индустриализация	N
нәзакәтлән	V
кудыр	V
автоинспектор	N
флейта	N
резидент	N
микроклимат	N
аморф	ADJ
асбест	N
тәрбияви	ADJ
ыргак	N
ферзь	N
идел	N
шаян	ADJ
кимлек	N
вузара	ADJ
матдә	N
тәхет	N
әйдә	V
батырлан	V
үрнәк	N
йогын	V
дрезина	N
калтыран	V
пьеса	N
гайбәтчел	ADJ
вакланма	N
союзара	ADJ
баск	N
аминокислота	N
метеоролог	N
ятма	N
кыйнат	V
кәлчәк	N
лыштырда	V
сортлан	V
автомашина	N
сельдь	N
чуклан	V
сызма	ADJ
тилгән	N
модернизация	N
атеист	N
телеграфист	N
комбинациялә	V
альма-матер	N
мәхшәр	N
вензель	N
өке	N
күндер	V
неврология	N
лейб-медик	N
бусы	N
кыярлан	V
классташ	N
чШр	N
күптөсмерле	ADJ
ачылыр-ачылмас	ADJ
мыекбай	N
крем	N
мыраула	V
әкият	N
класс	N
отвертка	N
шып	N
матрас	N
сылта	V
какшак	ADJ
гөлстан	N
таянчык	N
чайкат	V
кыңгыр	ADV
арат	N
җанландыр	V
материя	N
орчык	N
билирубин	N
чуар	ADJ
канонерка	N
интонация	N
майонез	N
мармелад	N
кылык	N
брак	N
ранг	N
серлә	V
чабыр	N
исән	ADJ
аксиома	N
сыеклан	V
хасла	V
үрел	V
әйле-шәйле	ADVV_NEG
реал	N
чирәм	N
корреспондент	N
чаж	N
минус	N
Шстәлек	N
рецензиялә	V
тотализатор	N
мөһерлә	V
чШш	V
отит	N
гәүдәләндер	V
инкассатор	N
күмдер	V
хәбәш	N
өченчел	ADJ
нефтебаза	N
биләмә	N
тылсымлан	V
кадерлә	V
бикәчлә	V
чукмар	N
теркәл	V
фонема	N
агент	N
искерт	V
жгут	N
учар	ADJ
бүлбе	N
тымык	ADJ
алласызлык	N
әпен-төпен	ADV
җиңел	V
ышыкла	V
йокы	N
ротмистр	N
дезинфекциялә	V
бөтенләй	ADV
җәйләт	V
коен	V
скальпель	N
каты-коты	N
кыюсызлан	V
җилпәзә	N
күгәр	V
механикалаштыр	V
түбәнге	ADJ
противогаз	N
искәртмә	N
фәлсәфә	N
дискриминациялә	V
үлчәт	V
рекламала	V
буровой	N
мәдрәсә	N
импрессионистик	ADJ
кызыл	ADJ
трансляция	N
бисер	N
тырпай	N
нейрон	N
теллелән	V
отель	N
кисәкчек	N
эпидемиолог	N
йола	N
алгыр	ADJ
элеккечә	PN
интерпол	N
департамент	N
мәзлүм	ADJ
мурт	ADJ
труппа	N
карак	N
төтек	N
хорафат	N
фабрикат	N
юмакайлан	V
специалист	N
йончы	V
детальлә	V
имтихан	N
урамдаш	N
кабардин	N
сессия	N
пудралан	V
тансыклан	V
колынла	V
мантилья	N
бата-калка	ADVV_NEG
чәүкә	N
безелдә	V
гуляш	N
этәрт	V
качкын	N
насвай	N
чи	ADJ
куакчык	N
бутерброд	N
беркайдан	ADVV_NEG
капиталь	ADJ
авызлык	N
джентельмен	N
киносценарий	N
беркавым	ADV
платан	N
буддизм	N
батон	N
төгәл	ADJ
хатын-кыз	N
ирландияле	N
җитдилән	V
катык	N
шик-шөһбә	N
герой-ана	N
атлант	N
сарык	V
канонада	N
бераз	ADV
аврал	N
машина	N
утракла	V
нәзек	ADJ
табала	V
аяз	V
драхма	N
төрмә	N
сарык	N
монополь	ADJ
геология	N
фетр	N
чурла	V
анык	ADJ
күптелле	ADJ
штраф	N
аркау	N
сеңерлән	V
цирк	N
хөсетлән	V
Шртәме-соңмы	ADV
учредительный	ADJ
шәҗәрә	N
кочегарка	N
Шсәплән	V
флагман	N
парафраза	N
баскетбол	N
губернатор	N
регистратор	N
интек	V
сейсмология	N
логика	N
уенты	N
династия	N
алгы	ADJ
централизация	N
дугалан	V
коңгыз	N
референт	N
чалгы	N
функция	N
румба	N
диверсия	N
култамга	N
фельетон	N
Шм-томчы	N
карбункул	N
тарала	V
аңгырай	V
сабак	N
таҗ	N
үтмәслән	V
яңрат	V
тарифла	V
скальп	N
якынлык	N
таслан	V
тапат	V
фәлән-төгән	N
эмфизема	N
реагент	N
ост	N
китешли	ADV
каган	N
космос	N
көрә	V
пышылдавык	ADJ
кендек	N
яңабаштан	ADV
фасонла	V
түбәнсен	V
ансат	ADJ
эсер	N
мыжгы	V
бөтеркә	N
кабалан	V
бал-маскарад	N
шпагат	N
сабыр	ADJ
унион	N
фрегат	N
табуретка	N
парчала	V
әсбап	N
кымты	V
спиртла	V
җилпәвеч	N
кигез	V
культпоход	N
гүр	N
галәбә	ADJ
чыгынты	N
экстремизм	N
ирек	V
чыршы	N
яшь	ADJ
ирек	N
шәхсән	ADV
экспресс	N
бильярд	N
ирис	N
аннотациялә	V
номенклатур	ADJ
инструктив	ADJ
нур	N
куелан	V
тергез	V
ку	N
гаеплә	V
фольга	N
җанла	V
запал	N
оңгы	N
өрфия	N
сайка	N
мәхәббәт	N
сентенция	N
төнката	ADV
ополченец	N
маскировкала	V
ку	V
хәйлә-мәкер	N
чыр	N
тишеклә	V
гер	N
стрелка	N
карагат	N
җибәрел	V
мәҗбүр	ADJ
үртәл	V
яшенлә	V
фотосинтез	N
чиркандыргыч	ADJ
панисламист	N
лосось	N
башы-ахыры	N
әйләнә-тирә	N
координацион	ADJ
кодекс	N
бәйнә-бәйнә	ADVV_NEG
инфузория	N
коммуна	N
биоген	ADJ
тасвирый	ADJ
шпор	N
варварла	V
түбәнсетел	V
бубен	N
ут	N
югарыла	V
тарих	N
борынча	N
яман	ADJ
вокализм	N
талым	N
черви	N
ревматизм	N
кәләпүш	N
физорг	N
җәйләвек	N
батальон	N
галәмәт	ADJ
өммәт	N
җилфердәт	V
зифалан	V
сазанак	N
тырпылдат	V
гиббон	N
теллән	V
кар	N
автобиографик	ADJ
керн	N
сүзчәнлән	V
түгәрәклән	V
колаша	N
сорат	V
чыжлат	V
дәргаһ	N
хакыйкый	ADJ
рапорт	N
йомык	ADJ
саман	N
бәпкә	N
критерий	N
семасиология	N
хуплан	V
зәңгәр	ADJ
параллелепипед	N
мөшкел	ADJ
автореферат	N
метрострой	N
Шсланд	N
биләнке	N
доза	N
киңәйт	V
доллар	N
лаванда	N
бызылда	V
бут	N
култык	N
тунат	V
иңкәй	V
прививка	N
рабби	N
искит	V
кварц	N
деканат	N
бинокль	N
тугла	V
өчпочмакла	V
кефир	N
чәкчәк	N
гаувас	N
шунсыз	PN
круиз	N
вәлүк	N
грузчик	N
туганлаш	V
бәргәлән	V
манифестант	N
ихтилал	N
разведчик	N
келдерә	V
ампутациялән	V
фыртлан	V
бишек	N
коендыр	V
карьеризм	N
йөз	N
цикута	N
цистерна	N
төйгеч	N
йөткерен	V
җәбер-җәфа	N
крахмал	N
такт	N
җиллән	V
очкалак	N
доминанта	N
купа	N
тоташлый	ADV
кыйгылда	V
штукатур	N
идиш	N
юнәл	V
йөз	V
маятник	N
кырдыр	V
тудырыл	V
магнат	N
келтер-келтер	ADV
артист	N
чукла	V
күкшел	ADJ
бруствер	N
жулик	N
немец	N
профессиональлә	V
караңгылат	V
планета	N
егет-җилән	N
иген-ашлык	N
салма	N
урынбасар	N
сутенер	N
бөртек	N
рентгенолог	N
ахун	N
чәңгелдәт	V
инструменталь	ADJ
мәгәр	CNJ
йортташ	N
нумизмат	N
микропор	N
префиксация	N
скандал	N
шамакай	N
электризация	N
үткесез	ADJ
былкылда	V
теләк	N
ликер	N
юбка	N
динамизм	N
хәрәм	ADJ
сырынты	N
тилпен	V
сузынкы	ADJ
пыялалан	V
Шнтеллект	N
атказан	V
күсе	N
романист	N
күбаяк	N
төйнәл	V
бераздан	ADV
кинән	V
бәхет	N
тозсызлан	V
йөгер	V
тензор	N
Шл	N
дунган	N
йомшакла	V
шарлотка	N
танец	N
инволюцион	ADJ
валюта	N
камчы	N
сарана	N
бертын	ADV
пырылдат	V
битәрлә	V
чардак	N
тотлык	V
либеральлә	V
бахыр	N
констатациялә	V
ашыр	V
мандарин	N
блюз	N
шәп	PREF_ULTRA
чукраклан	V
фанатизм	N
эләктергеч	N
пескәй	N
онык	N
корыл	V
миннәт	N
агрегат	N
тәртә	N
күкрәкчә	N
безелдәвек	N
диаграмма	N
юкарт	V
плюс	N
тотка	N
симметрия	N
аны-моны	PN
котик	N
табор	N
иген-икмәк	N
соры	ADJ
Шсәрлән	V
лея	N
җимлә	V
церемония	N
гладиолус	N
садә	ADJ
хамит	N
алгысыт	V
хөллә	N
картотека	N
чыгарыл	V
селке	V
туган-ыру	N
шевалье	N
контрхәрәкәт	N
пырхылдат	V
кинокартина	N
кан	V
шәфкатьсезлән	V
инкарь	N
күшектергеч	ADJ
үлчәм	N
корша	V
фибрин	N
болгат	V
дотация	N
агломерация	N
гонококк	N
чеңгелдә	V
асылма	ADJ
аскет	N
калдыр	V
комендант	N
квинта	N
кан	N
дирижабль	N
арсенал	N
төшенер-төшенмәс	ADJ
өченчекөн	ADVV_NEG
эскадра	N
гарт	N
ихтыяри	ADJ
форум	N
карагач	N
зар	N
тангенс	N
киная	N
охра	N
тиберчен	V
таяу	N
гренадер	N
Шлдәш	N
партком	N
көрәгә	N
колакча	N
кичә	N
җам	N
ныгыттыр	V
кордиамин	N
тутлан	V
андый	PN
ренегат	N
авырт	V
түтәлчек	N
капкын	N
суүлчәгеч	N
йомырыл	V
өс	N
лейцин	N
помидор	N
көмеш	N
кастет	N
кит	V
өстә	V
франт	N
геноцид	N
тәм-том	N
җиләс	ADJ
басынкылан	V
комбинациялән	V
йотма	N
перфокарта	N
актарт	V
плазма	N
сөя	V
купальник	N
фахиш	ADJ
биомицин	N
мотокросс	N
иңрә	V
кирәк-ярак	N
сылат	V
фазан	N
төзлек	N
пульсар	N
лепелдә	V
мастер	N
кич	ADVV_NEG
тавык	N
диагональ	N
кәрзин	V
июнь	N
уйма	N
күптиражлы	ADJ
танк	N
фат	N
чокын	V
фюзеляж	N
баягынак	ADV
фәсахәт	N
унҗиде	NUM
иртәнгә	ADV
юрамал	ADV
дустанә	ADVV_NEG
бияләй	N
планет	ADJ
дарчин	N
маочы	N
рекогносцировка	N
классицизм	N
мәрхәмәтсезлән	V
салын	V
лыштыр-лаштыр	ADV
диндар	ADJ
юын	V
лак	N
кибернетик	N
телемлән	V
типтәр	N
художник	N
тибенге	N
мәйдан	N
тәти	N
топонимика	N
панно	N
күшек	V
периодизация	N
гносеологик	ADJ
гадәтлән	V
автохтон	N
характеристика	N
ләззәтлән	V
безлә	V
чалбар	N
троцкизм	N
күрәзәлә	V
кольт	N
саам	N
өшән	ADJ
счет	N
архивариус	N
лобзик	N
иртәле-кичле	ADVV_NEG
вальс	N
сук	V
ажур	ADJ
протестант	N
ялпак	ADJ
саркофаг	N
монополиялә	V
бүрәнкә	N
җилпен	V
җим	N
чылгый	N
ташбилге	N
бүләк	N
җай	N
вокзал	N
гангрена	N
чумдыр	V
жалоба	N
торпеда	N
сөрмәлә	V
сызгандыр	V
пешек	N
квота	N
гравюра	N
райфо	N
кисәк	N
йөрен	V
группа	N
расшифровка	N
кобза	N
нашатырь	N
центризм	N
тимер-томыр	N
тасрай	V
әчет	V
проблематик	ADJ
плотина	N
фундамент	N
букса	N
купшыла	V
аксу	ADJ
ботаклы-чатаклы	ADJ
илбасар	N
синолог	N
истерия	N
тукмар	N
байтак	ADJ
демагогия	N
пейзаж	N
торт	N
дулкынландыргыч	ADJ
ревизионист	N
шапшакла	V
факир	N
ырылда	V
панорама	N
детерминант	N
домкрат	N
убыл	V
юанайт	V
киндерә	N
яткыр	V
җШң	V
салынкылан	V
терәл	V
балкы	V
амнистия	N
кәпрәй	V
җәберсен	V
үзлелән	V
тюрколог	N
тигез	ADJ
бүрәнә	N
микрометр	N
парадигма	N
сигәк	ADJ
кичәгенәк	ADVV_NEG
фактография	N
мазь	N
урбанизм	N
политехнизация	N
баш	N
сыкран	V
языклан	V
реформа	N
Шнша	N
себер	V
сюртук	N
бушлат	N
та	N
көз	N
экскурсия	N
эскәклә	V
кыштырдык	ADJ
гасабилән	V
өшкер	V
кирәк-кирәкмәгән	ADJ
миллиграмм	N
гөрбиян	N
адмирал	N
рододендрон	N
кистән	N
Шгез	ADJ
хореографик	ADJ
тыгызлаткыч	N
күрен	V
нәүрүз	N
нар	N
нуктала	V
малай-шалай	N
беркайда	ADV
хорей	N
тиреслән	V
юынтык	N
уал	V
газый	ADJ
газла	V
синод	N
өй-тирә	N
конферанс	N
геллер	N
гасыр	N
бөдрә	ADJ
кыз	N
тайгаклан	V
каток	N
лошпырдат	V
кечерәйт	V
кыз	V
драп	N
кандил	N
очлайт	V
лоббист	N
натура	N
консерватория	N
тарификация	N
пычрат	V
категорик	ADJ
болганчыкла	V
ваклагыч	ADJ
кырдаш	N
тәфсир	N
татылда	V
тайгак	ADJ
драмалаштыр	V
тулга	V
релятивистик	ADJ
турайт	V
эпилог	N
авторлаштыр	V
куык	N
алкоголь	N
контрреволюцион	ADJ
итләч	ADJ
русчалат	V
медсанбат	N
калгы	V
атландыр	V
үшән	ADJ
пружина	N
авиатор	N
кремация	N
баласыт	V
ампула	N
механизатор	N
чаткылан	V
лакла	V
протон	N
полоса	N
күтәрт	V
әчмуха	N
самогон	N
илдәш	N
сейсмик	ADJ
сөннәтлә	V
кәбәм	N
хиромантия	N
кубалак	N
ай	N
тубалак	N
фаянс	N
уһылда	V
җәннәт	N
фальш	N
уйнал	V
орбиталь	ADJ
кәрамәт	N
татарчалык	N
чакма	N
гаугачыл	ADJ
лифт	N
шудыр	V
простыня	N
аксак	ADJ
чертеж	N
яманлат	V
секта	N
интегралла	V
берөзлексез	ADV
символист	N
Шгәч	N
алка	N
маркетинг	N
кайт	V
лекторий	N
төкселән	V
шылтырат	V
сайлык	N
чинат	V
бордо	N
торымтай	N
тоташтыргыч	N
пробирка	N
ләпек	N
бервакытта	ADV
сокландыргыч	ADJ
эремә	N
карагай	N
префектура	N
копировка	N
санәм	N
ликбез	N
обыватель	N
дисбе	N
пульс	N
ыспайла	V
нигезлән	V
почмаклан	V
хозурлан	V
редакциялә	V
механика	N
тәм	N
мәхлук	N
динамо	N
чуер	N
Шдел	N
потенциал	N
аванс	N
кырагай	N
меценат	N
иярчен	N
тасла	V
инерт	ADJ
кассация	N
монархистик	ADJ
инструмент	N
башкала	N
җитлек	V
чәкәнлә	V
митинг	N
шаталак	ADJ
постау	N
натуралист	N
алагаем	ADV
военрук	N
күкрәк	N
курсив	N
кәшәкә	N
кем	PN
тур	N
күчерелмә	N
тотым	N
уртла	V
малай-салай	N
фармакологик	ADJ
түгел	PN
ханжа	N
күкбүзат	N
бүтәнәй	V
сындыр	V
үзмаксат	N
дифтерия	N
максатчыл	ADJ
дифтонгла	V
ырымлан	V
идиоматик	ADJ
арктика	N
антипатриотик	ADJ
шешемсерә	V
горилла	N
җәһәтлән	V
накат	N
дүсмәт	N
дерматолог	N
сула	V
җефет	N
книксен	N
шәлле	ADJ
Шртәгә	ADVV_NEG
интернационалистик	ADJ
басыл	V
собор	N
балала	V
артталык	N
шәл	N
зилзилә	N
каракаш	N
ябарлык	ADJ
микрофон	N
дүрт	NUM
пешеклә	V
большевик	N
йомырка	N
контузиялән	V
моңай	V
фотокамера	N
җуел	V
куллан	V
җШл	V
чыкырда	V
ностальгия	N
берьюлы	ADVV_NEG
акча	N
итәк-чабу	N
чучка	N
реформация	N
раввин	N
ышкын	V
инженер	N
тынчулан	V
штор	N
чабын	N
кыякла	V
шулчаклы	PN
электромеханика	N
лыгырдан	V
чуарла	V
концентрацион	ADJ
кассап	N
банкнот	N
геодезист	N
тутыр	V
арзанчылык	N
камбий	N
византияле	N
киң	ADJ
табель	N
товар	N
чиклә	V
фиргавен	N
линимент	N
сакля	N
филология	N
ямьлә	V
бактериолог	N
мин-минлән	V
офицер	N
бәбәнәк	ADJ
рәт	N
сентиментализм	N
козырек	N
заложник	N
чирлә	V
космополитик	ADJ
палеолит	N
Шфадә	N
ялкаулан	V
кафедра	N
субстрат	N
әмәлләт	V
туракла	V
бервакыт	ADV
дорфа	ADJ
газогенератор	N
бүртен	V
палитра	N
бәйрәмлә	V
автовокзал	N
гарьчел	ADJ
кул-аяк	N
ритуаль	ADJ
сколиоз	N
малайчак	N
уртанчы	ADJ
изафә	N
ассимилятор	ADJ
төкселек	N
кип	N
вавилонлы	N
стафилококк	N
лыкылда	V
сатрап	N
биниһая	ADVV_NEG
параша	N
суырыл	V
микрокристаллик	ADJ
агитациялә	V
третейский	ADJ
тәртипсезлән	V
якташ	N
томансу	ADJ
югослав	N
кубок	N
әрҗә	N
талон	N
бүгенге	PN
киприот	N
колонна	N
вәкил	N
костел	N
гидай	N
Шренчәк	ADJ
хурлан	V
русификатор	N
таксометр	N
җөббә	N
үзле	ADJ
районла	V
симпозиум	N
приз	N
Шнкарь	N
фатир	N
ябык	V
катай	N
дырылда	V
прогрессист	N
муллык	N
бетен	V
демократия	N
зәвыклан	V
иллюзион	N
аллея	N
телеграф	N
яма	V
гөмбә	N
игенче	N
чупылда	V
иллюминация	N
нигилизм	N
коймалан	V
законла	V
тутырма	N
үзара	ADVV_NEG
ишерел	V
чытыр	N
изгеч	N
сапер	N
йөзлеклә	V
рельефлы	ADJ
чәчәт	V
аңлат	V
җиһан	N
кычыткан	N
күчем	N
храм	N
партизанка	N
сантиметр	N
яраулы	ADJ
күбек	N
тишек	N
чолгат	V
реактор	N
дәва	N
кос	V
домна	N
кунакла	V
җәяүлән	V
стимулятор	N
пижон	N
шартаяк	N
кушаяк	N
исәплә	V
электролиз	N
сап	PREF_ULTRA
Шртәлә	V
изоляциялән	V
тоталитаризм	N
сипкеллән	V
триллион	N
куй	V
суык	N
мохтаҗ	ADJ
инструментарий	N
авария	N
телевидение	N
йог	N
күптәннән	ADVV_NEG
идиллик	ADJ
экстраполяция	N
редакцион	ADJ
калынай	V
кубалаклан	V
спазматик	ADJ
тулай	ADJ
баштүбән	ADVV_NEG
кымырҗы	V
капиталистик	ADJ
үт	N
чик	V
хушбуй	N
зыңгылда	V
комплекс	N
почык	ADJ
өйрәт	V
ырла	V
конвоир	N
тыныч	ADJ
күкселләт	V
саранлан	V
загс	N
ашказаны	PN
мәдхия	N
тент	N
шанлы	ADJ
көчсезләт	V
банка	N
персона	N
өлгелә	V
вәйран	N
тугай	N
примитив	ADJ
пурген	N
сөңге	N
киги	N
тугай	V
көчәй	V
эссенция	N
август	N
соло	N
парфюмерия	N
күпсүзле	ADJ
ука	N
канәгатьчел	ADJ
род	N
ят	ADJ
изгелән	V
үсмерчак	N
аппагым	N
тапкыр	ADJ
хәтерлә	V
эпифиз	N
чөмәк	N
чыңлат	V
Шлче	N
новокаин	N
киме	V
бүксә	N
колакчын	N
ясалгы	N
одеял	N
Шкелән	V
мосафирханә	N
рәсми	ADJ
губерна	N
сузык	ADJ
сөймән	N
пропагандист	N
катырган	ADJ
аллы-гөлле	ADJ
юат	V
лексикография	N
коверкот	N
бастырык	N
кабина	N
кощык	N
ихтиология	N
Шлек	N
энтомолог	N
байбак	N
четереклән	V
күтәрткеч	N
туар	V
секундомер	N
коллапс	N
мандолина	N
узган	ADJ
урда	N
үҗәт	ADJ
какча	ADJ
корылык	N
әрдәнәлә	V
җитезлән	V
күрәкара	V
лепелдәт	V
эмоция	N
төклетура	N
син	PN
стерлинг	N
рашкы	N
каркас	N
идиот	N
артерия	N
күнәк	N
дозала	V
эмблема	N
сероводород	N
ирәй	V
җШрсү	N
чүп	N
чәрелдәвек	ADJ
дисциплинар	ADJ
тәңкәлә	V
эликсир	N
ялантәпи	ADV
олак	V
дыңгычла	V
шампиньон	N
пШ	N
иләслән	V
юашлан	V
күрсәтел	V
имин	ADJ
сөйкемсез	ADJ
католицизм	N
бөрчек	N
эретмә	N
мә	ADJ
олуг	ADJ
рецидив	ADJ
артикль	N
кодача	N
күгән	N
лыпырда	V
хәреф	N
олыла	V
Шмгәт	V
каннибал	N
дары	N
хакимият	N
мөлкәт	N
күрсәткеч	N
биллә	V
ниппель	N
ранец	N
изоляциялә	V
теш	N
унты	N
союздаш	ADJ
деформациялән	V
борма-борма	ADJ
фәс	N
алыпсатар	N
засада	N
яскан	V
диңгез	N
кыямәт	N
исер	V
сипләт	V
сеньорита	N
карамай	N
погром	N
әшкарә	N
пүнәтәй	N
хитап	N
штрейкбрехер	N
ирен	V
сыкта	V
Шке	NUM
дегустация	N
эзәрлеклән	V
юнан	N
лачкылдат	V
өтелә	V
кискәлән	V
ялат	V
балачыл	ADJ
браконьер	N
манер	N
ординатура	N
бомбовоз	N
жетон	N
шоңкар	N
сотый	N
ирен	N
чекист	N
демократик	ADJ
шәйлә	V
треска	N
сирәк-мирәк	ADV
түгел	V
империя	N
каула	V
изгелек	N
җорлан	V
имажинизм	N
бетонлан	V
җибәр	V
балкар	N
чәкәлә	V
михраб	N
кайра	N
йомшак	ADJ
үзгә	ADJ
сублимация	N
ялтыравыкла	V
куптар	V
оеткы	N
йолкышлан	V
бик	ADVV_NEG
электрон-исәпләү	ADJ
кожанка	N
кибен	V
хазар	N
катер	N
иман	N
нерпа	N
көпә-көндез	ADVV_NEG
кашне	N
кабих	ADJ
автоинспекция	N
кәсептәш	N
автоматла	V
октава	N
ышкылан	V
вәсвәсә	ADVV_NEG
кайнарлан	V
кощыгым	N
әйткәлә	V
Штләч	ADJ
иртәме-соңмы	ADV
эшсөяр	ADJ
апробациялән	V
шулчак	PN
мимоза	N
баба	N
сода	N
фырылда	V
досье	N
шүрләт	V
конфискациялә	V
көзлә	V
шәбәр	V
кайчакларда	ADVV_NEG
кисемтәлә	V
илтифат	N
чумиза	N
келтерәт	V
сиз	V
кашык	N
христианла	V
зәвык	N
салон	N
тикмә	ADJ
югарылан	V
тәҗе	N
әүмәклә	V
чөкердә	V
кысым	N
истер	V
террор	N
квартир	N
куйчы	N
тәпәрлә	V
чак	N
каралан	V
сеңерчә	N
гимнастка	N
чак	V
вегетатив	ADJ
минералогия	N
Шркенлә	V
алапай	N
тамаша	N
группала	V
гөлсирин	N
йөремсәк	ADJ
сырлы-сырлы	ADJ
чачак	N
визит	N
җилбәзәклә	V
спринт	N
таза	ADJ
Шсәкәй	N
шрифт	N
пичәтлә	V
районо	N
зыңгылдат	V
сеңел	N
тыртай	V
бәдән	N
гүзәл	ADJ
начальство	N
төйнә	V
йомарла	V
гармоник	ADJ
нурла	V
синекдоха	N
урынла	V
светофор	N
лимонник	N
белеклек	N
склад	N
төпләм	N
билгелән	V
гаңгылда	V
йомарла	N
карья	N
төткәр	V
күпмеләп	PN
лактоза	N
пыяла	N
җәнүп	N
ритуал	N
йөнтәслә	V
муниципалитет	N
күзикмәк	N
тарихчы	N
иммунитет	N
өн	N
бурат	V
тачанка	N
олылан	V
ургы	V
маемла	V
молекуляр	ADJ
тиңлә	V
лаякыл	ADV
итен	V
дәлил	N
хаҗ	N
плагиатор	N
авиатехник	N
бантик	N
микрофлора	N
артель	N
хәнҗәрлә	V
туганым	N
таша	V
сакалбай	N
килограмм	N
кета	N
гыйлем-мә	N
буял	V
озынборын	N
тизләткеч	N
күләм	N
куакчыл	ADJ
пуристик	ADJ
тирә-юнь	N
ымсындыргыч	ADJ
зәңгәрлә	V
күгәрченкәй	N
лацкан	N
җикер	V
антракт	N
чүбеклә	V
корычла	V
балерина	N
чилән	V
котыйчык	N
йөгәнлән	V
тияк	N
ювелир	N
кәй	ADJ
шарабан	N
чабар	N
шом	N
бихисап	ADVV_NEG
психолингвистика	N
анатомик	ADJ
актив	N
стенограмма	N
рагу	N
мохит	N
чымырдат	V
флюс	N
табак	N
борылгысыз	ADJ
метрология	N
җимешлән	V
китек	N
институт	N
чакрым	N
һиһелдә	V
күрәзә	N
корчаңгы	ADJ
хәстәханә	N
кашемир	N
шыптырда	V
җилпуч	N
тәнлән	V
конторка	N
медкомиссия	N
сирәк-мирәк	ADVV_NEG
межалан	V
такталан	V
ямь	N
куш	ADJ
фортепиано	N
төтенлә	V
галантерея	N
культиватор	N
генетика	N
океанограф	N
түләмә	N
штуф	N
следователь	N
арлы-бирле	ADJ
шыңгырда	V
иңгә-иң	ADV
чукмарла	V
ашыктыр	V
пирожный	N
педант	N
уын	V
ары	V
этикетка	N
экскурс	N
җыерчык	N
бюрократизм	N
хәяти	ADJ
стипендиат	N
нейтралитет	N
өстәмә	ADJ
пресслан	V
бөкре	ADJ
бостон	N
трансформация	N
җиңгәчи	N
субсидия	N
ипсезлә	V
атмосфера	N
шалкан	N
кашак	N
юнәлдергеч	ADJ
рафинад	N
сагындыргыч	ADJ
багажник	N
чутылда	V
кодагый	N
антоциан	ADJ
командор	N
киле	N
варенье	N
чуан	N
агайне	N
ревматик	N
диоптр	N
яңгыравык	N
татулан	V
сөям	N
үзәнсу	ADJ
аерыл	V
төрпә	ADV
чыгарылма	N
челпәрәмә	ADV
тал	N
бунтарь	N
изалан	V
татарла	V
үгисет	V
тал	V
караңгылан	V
дәртлән	V
чит	N
уналты	NUM
чыбыкла	V
эрбет	N
кондор	N
маһиранә	ADV
махау	N
әвәлә	V
бөгелмәле-сыгылмалы	ADJ
стоматология	N
сука	N
уентык	N
наркомания	N
корылан	V
чагыр	ADJ
кичәле-бүгенле	ADVV_NEG
эмигрант	N
гөпелдәт	V
горчичник	N
квартет	N
ябыклык	N
кылавын	N
киностудия	N
буфер	N
чалышай	V
табын	V
көбә	N
тырыш	V
иттер	V
драма	N
факсимиле	N
фонтанла	V
полицай	N
килерле	ADJ
турай	V
әммә	CNJ
Шрдәүкә	N
чылтыра	V
дөя	N
апелляция	N
турсык	N
пошымсыз	ADJ
ялыктыргыч	ADJ
таркау	ADJ
тасырда	V
әлбәт	N
яшерен-пошырын	ADJ
мамонт	N
ингуш	N
рационалистик	ADJ
утопик	ADJ
авиамоделизм	N
шомар	V
детерминизм	N
акробатика	N
әбәт	N
тәҗрШбә	N
чәчәклә	V
хасталан	V
клише	N
кислород	N
уртакла	V
икейөзлелән	V
стенографист	N
муртай	V
алгы	V
параллелограмм	N
токмач	N
инкассация	N
далмат	N
пассивлан	V
формат	N
тургай	N
буша	V
мактан	V
үзбаш	ADV
прилавка	N
берничә	PN
оброк	N
әйләндергеч	N
бутсы	N
сульфат	N
югыч	N
ом	N
быкылда	V
абориген	N
иңдер	V
мундир	N
бәр	V
сискән	V
сафла	V
рәхәтлән	V
тузгак	ADJ
плюш	N
шпунт	N
анабиоз	N
холуй	N
төзелмә	N
сыйлан	V
ары-бире	ADVV_NEG
төяк	N
педология	N
ленинградлы	N
хәрби-техник	ADJ
пошалан	V
территориаль	ADJ
коммунист	N
аноним	ADJ
чүнник	N
калым	N
классификациялә	V
каргал	V
виноград	N
волонтер	N
билгеләт	V
чутырда	V
тетрән	V
демонтаж	N
переворот	N
җиләслә	V
ортодокс	N
машбюро	N
тырылдат	V
манчыл	V
характерлан	V
совет	N
реакция	N
челек	N
өше	V
лейка	N
аткый	N
гексохлоран	N
пат	N
буза	N
авырлан	V
фоторепродукция	N
һиндыба	N
ни	PN
фотограф	N
партконференция	N
шырлык	N
даосизм	N
букет	N
беркеткеч	N
торба	N
ышылда	V
форт	N
теркә	V
каеры	N
саулык	N
астрофизика	N
узурпатор	N
талпан	N
вакса	N
катехизис	N
томыр	V
вәзгыять	N
чәчкап	N
танык	N
кимоно	N
корсет	N
ширбәт	N
гарь	N
ансыз	PN
инабәт	N
ачуташ	N
кичектер	V
ахшам	N
пезо	N
киртәлә	V
осетин	N
героизм	N
тренировка	N
антанта	N
утла	V
чиркәү-славян	ADJ
трафарет	N
маскарад	N
демагог	N
атай	N
хәвеф	N
редколлегия	N
якла	V
әйләндер	V
авторучка	N
архитектор	N
нарта	N
күнеккән	ADJ
люмпен	N
сепаратист	N
ялтыраткыч	N
шапырда	V
ямб	N
күшә	N
радиоинформация	N
алдат	V
чукы	V
җирсет	V
күшә	V
вексель	N
кайтарт	V
обелиск	N
аналог	N
салкынайт	V
хөкемдар	N
акрынла	V
зыңла	V
коштабак	N
конверт	N
планка	N
уелма	N
эфиоп	N
бандит	N
анализла	V
риторик	ADJ
микробиология	N
бервакытта	ADVV_NEG
лексикон	ADJ
мәскәүле	N
көнге	ADJ
чарык	N
йолык	V
универсам	N
штепсель	N
стадия	N
вәхшШ	ADJ
фатализм	N
тәравих	N
шаблон	N
козау	N
ныгай	V
сокландыр	V
димлә	V
гая	N
корамала	V
копер	N
мәңге	ADV
стадион	N
шытым	N
сайра	V
чебилән	V
Шсерек	N
Шплә	V
иҗаби	ADJ
төткәз	V
төтенләт	V
сепарат	ADJ
ютәл	N
премия	N
алагаем	ADVV_NEG
катамаран	N
мөгәрич	N
шотландка	N
мюзик-холл	N
камәр	N
драматик	ADJ
пеон	N
ишек	N
миналан	V
обойла	V
конструктивизм	N
ноябрь	N
күкташ	N
кинәттән	ADVV_NEG
күәс	N
дастан	N
очын	V
гарнизон	N
итчел	ADJ
кушамат	N
этимон	N
самимият	N
продразверстка	N
сора	V
шапалак	N
хлор	N
гыйш-гашрәт	N
севрюга	N
ересь	N
этнографизм	N
Шдея	N
флер	N
гаммә	N
каршылан	V
сөйләк	N
постулат	N
тинтәк	ADJ
шундый	ADJ
мосафир	N
хәзинә	N
талкан	N
метаморфоза	N
Шнфаркт	N
эпигон	N
пакет	N
шампанский	N
әүвәлге	ADJ
рецензент	N
рояль	N
тулымса	N
финанс	ADJ
зооветеринария	N
кыз-кымыз	N
альт	N
эскорт	N
эшлеклелән	V
әрсез	ADJ
гәрәбә	N
комачаула	V
эчләт	V
лемма	N
танкодром	N
волынка	N
туплам	N
ялтырат	V
ишкәгаяклылар	N
мәкер-хәйлә	N
талчыбык	N
хәбәр	N
әйбәтлән	V
мартен	N
саңгырау	ADJ
беркөнне	ADV
атакала	V
каракош	N
ультракыска	ADJ
пероксид	N
турак	N
һөнәрдәш	N
халат	N
бакыр	N
реставратор	N
аймак	N
кырла	V
вертолет	N
слайд	N
бакыр	V
киртәлән	V
атлан	V
җылыт	V
формальдегид	N
дәртләндер	V
тәгалә	N
омар	N
амфора	N
үтүк	N
маҗара	N
азат	N
конферансье	N
солы	N
бакырт	V
керт	N
чырай	N
герц	N
тиле	ADJ
өрке	V
сугыш	N
бавырсак	N
киңәштәш	N
гаиләчел	ADJ
олеандр	N
җилкендер	V
кортеж	N
керт	V
карасакал	N
азак	ADJ
әрәмтамак	N
талымсак	ADJ
алла	V
тешлән	V
альбуцид	N
карала	V
кабыкла	V
алын	V
алла	N
комитет	N
тәмсезлә	V
кабаттан	ADVV_NEG
оер-оемас	ADJ
өр-яңа	ADJ
килен	N
морат	N
пеше	ADJ
сүрән	ADJ
авырайт	V
имнә	V
катканак	ADJ
шикелле	PN
галет	N
төпкел	N
маргаритка	N
аңлар-аңламас	ADJ
малай	N
морфологик	ADJ
космология	N
бенефис	N
эт	V
эшләт	V
кикерт	V
лап	ADV
резолюция	N
аралаш	V
запас	N
барышник	N
молекула	N
тархан	N
үткер	ADJ
нигезлә	V
механистик	ADJ
чүрәкәй	N
бизен	V
тимераяк	N
монтаж	N
бөтеркәч	ADJ
эт	N
марксистик	ADJ
норд	N
ниргәлә	V
ләпелдәвек	N
бишбылтыр	ADVV_NEG
шыгрым	ADVV_NEG
елт	ADV
хәвеф-хәтәр	N
дымла	V
чәйлә	V
модельер	N
пояс	N
чаян	N
дыңгырда	V
борчак	N
семиотика	N
гербицид	N
бензовоз	N
төнлә	ADV
әйдәлә	V
нәкәс	N
кувалда	N
коршау	N
сат	V
гафләт	N
химикат	N
кибәкбаш	N
такси	N
самокат	N
борылма	N
купшы	ADJ
сабый	N
вәхшилә	V
Шнформбюро	N
партгруппа	N
көлемсәр	ADJ
кагын	V
табакташ	N
көрәйт	V
сәфәрдәш	N
сирәк-сирәк	ADV
үтенеч	N
кырык	NUM
сихәт	N
унитаз	N
чакыр	V
характер	N
трибунал	ADJ
иренлә	V
чандыр	ADJ
блокировка	N
болыт	N
унбиш	NUM
кочак	N
силә	N
башкортлаштыр	V
нугай	N
тройка	N
райбашкарма	ADJ
нигездәш	N
абзар	N
кәнфит	N
номинатив	N
хулиган	N
сироп	N
эксперт	N
җенес	N
физиологик	ADJ
нефрит	N
тезген	N
шуңача	PN
футбол	N
мурда	N
ретушь	N
силосла	V
шомарткыч	N
Шк	V
манзара	N
гемоглобин	N
эленмәле	ADJ
гәрчә	CNJ
җан	N
дүшәмбе	N
координация	N
сыдырт	V
мөстәкыйм	ADJ
политсостав	N
тумбочка	N
чалтырат	V
дистанцион	ADJ
иреш	V
потенциаль	ADJ
тик	CNJ
суыт	V
провокатор	N
якындагы	ADJ
анемия	N
сиптер	V
юбиляр	N
маневр	N
грандиоз	ADJ
тешә	V
җыйнак	ADJ
конверсия	N
бөтеркәлән	V
каллиграфик	ADJ
аңлашылмастай	ADV
актирәк	N
антисанитар	ADJ
сүслә	V
дус-иш	N
ранчо	N
конкрет	ADJ
ябырыл	V
бетләт	V
өтергелә	V
тыел	V
продукция	N
тынычлан	V
ватык-сынык	N
айка	V
взнос	N
көрмәк	N
күпмелек	PN
Шнтеллектуаль	ADJ
мәңгегә	ADVV_NEG
савап	N
бөркү	ADJ
полемик	ADJ
силикат	N
калҗы	V
көч	N
торкылда	V
мәрхүм	N
хөррият	N
землянка	N
хәлиткеч	ADJ
Шшегалды	PN
барабан	N
кыерчык	N
көнчыгыш	N
иттифак	N
сак	N
гөпелдә	V
чәнәшкә	N
трубка	N
буксир	N
сәүдәгәр	N
оператор	N
вегетацион	ADJ
вакытлыча	ADVV_NEG
чин	N
ышкыла	V
хәрәкәтлән	V
ботак-тармак	N
деривация	N
директория	N
вербаль	ADJ
чәүчәләк	ADJ
лейкоцитлар	N
тавтологик	ADJ
казыгыч	N
команда	N
күккүз	N
камчат	N
гел	ADV
элен	V
мишура	N
глиссер	N
пеницилин	N
доминион	N
патогенетик	ADJ
террористик	ADJ
тайфун	N
бөрлегән	N
кыйсем	N
кабарт	V
тәрәккыят	N
плаун	N
вилла	N
өлкәр	N
секс	N
монах	N
керфек	N
кубик	N
пироксилин	N
имана	N
кинопрокат	N
скрипка	N
җанкай-җанаш	N
игәү	N
сырт	N
тушь	N
төркемлән	V
чүре	N
зыян	N
файдалан	V
алтынлан	V
механик	N
бетерел	V
айкал	V
нормала	V
стетоскоп	N
җибәрт	V
ахыргы	ADJ
палас	N
инвентаризация	N
лампас	N
бритва	N
сикергеч	N
телетайп	N
суффикс	N
аскы	ADJ
фужер	N
фотолаборатория	N
космоплан	N
фәллах	N
кыйгай	V
норвег	N
панель	N
гофмаршал	N
ахахайла	V
Шркә	ADJ
тентет	V
тулы	ADJ
лифчик	N
икәүләшеп	ADV
Шфтар	N
фагот	N
радиола	V
чемлә	V
арык	ADJ
вакыйгән	ADJ
болын	N
буран	N
театрал	N
шартлагыч	N
идальго	N
чәчтәңкә	N
нотация	N
тагарак	N
үрсәлән	V
мүклән	V
шизофрения	N
Шлһам	N
председатель	N
фотометр	N
кылла	V
диалектик	N
антиколониаль	ADJ
пилмән	N
чер	V
куну-төнү	N
пленум	N
белән	CNJ
анекдотик	ADJ
каптенармус	N
кикрик	N
түнтәр	V
чәбәлән	V
бавыргалык	N
гүзәллә	V
соңгар	V
приват-доцент	N
таныт	V
тупаслан	V
җитенкерә	V
ишарәт	N
борыс	N
эреткеч	ADJ
тулыландыр	V
мобилизацион	ADJ
прагматик	N
сузылма	ADJ
кыл	V
уртак	ADJ
сагынмалык	N
кыл	N
йөрткеч	N
тайтояк	N
бот	N
чүпләм	N
мачта	N
парторг	N
афәт	N
өченчекөн	ADV
инстинкт	N
сыкыла	V
партадаш	N
кесәл	N
җШтдШ	ADJ
эпицентр	N
чиләк	N
быелга	ADVV_NEG
ярамастай	ADV
пәрдәлә	V
сәнәк	N
борын	N
арифметик	ADJ
уптым	ADV
суганча	N
бутафория	N
шигәй	V
узган-барган	ADJ
анализлан	V
нотариус	N
күкселлән	V
байрак	N
комбинация	N
мелодраматизм	N
тастар	N
газраил	N
безелдәт	V
диффуз	ADJ
дог	N
тырыс	N
кәмәр	N
хлорид	N
умыртка	N
җәрәхәтлән	V
күч	V
бәлзәм	N
рухлан	V
товарный	ADJ
эпидемиология	N
тозлак	N
суффиксаль	ADJ
бәйләгеч	N
терәткеч	N
чебилә	V
филантроп	N
бала-чагалан	V
цех	N
зарурат	N
уен-көлкечел	ADJ
рессор	N
суккыч	N
курьез	N
орфографик	ADJ
панславизм	N
операнд	N
камбуз	N
лыҗырда	V
шыбырдат	V
микрофильм	N
соңра	ADVV_NEG
тәүрат	N
Шркенәй	V
комкор	N
кыскалык	N
планшет	N
иллюстратор	N
җанвар	N
кордебалет	N
рөхсәт	N
ярала	V
стерилизациялә	V
монометр	N
конкретла	V
опус	N
элекке	ADJ
мәте	N
өйрәнчек	ADJ
легионер	N
юриспруденция	N
фуксия	N
эмаль	N
китешли	ADVV_NEG
селек	V
акрын	ADJ
былчырак	ADJ
түгем	N
мексикан	ADJ
шасси	N
массажла	V
арзан	ADJ
археология	N
курач	ADJ
туктаткыч	N
суррогат	N
керамика	N
хәтерсезлән	V
инженю	N
оет	V
транслитерациялә	V
позер	N
колонияләштер	V
өметсезлән	V
наушник	N
ионла	V
кризис	N
бөркән	V
хаталан	V
котылдыр	V
ырлат	V
кошкай	N
грифон	N
шрапнель	N
ягын	V
полимерла	V
ревизор	N
лейкопластырь	N
куйдыр	V
аңлаешлы	ADJ
ил-көн	N
маскировка	N
исемлә	V
өмет	N
чытык	ADJ
штамп	N
кубометр	N
йөнтәс	ADJ
билдәмә	N
ач	ADJ
кафель	N
химая	N
җирәнсу	ADJ
йолдызлан	V
оныт	V
гыйрфан	N
ставка	N
пышкылда	V
урядник	N
эшкәртмә	N
сөрлек	V
штукатурла	V
чарлат	V
тирә	ADJ
Шмпульс	N
ис-акыл	N
аркадаш	N
Шр-егет	N
спекулянт	N
богаула	V
вектор	N
им-томчы	N
гардероб	N
ярымчүл	N
линкор	N
тулгакла	V
чиялән	V
тирәк	N
камыш	N
чәңгелдә	V
кич-иртә	N
авыл	N
лШтр	N
интервью	N
дымсулан	V
ситсы	N
француз	N
пәке	N
агымсу	N
сусыллан	V
каскад	N
чукча	N
тешләк	ADJ
ханбикә	N
үс	V
сандали	N
шансонетка	N
ясмык	N
тарантул	N
мистик	ADJ
тотын	V
кабарткыч	N
ян	N
гашыйк	N
меньшевик	N
күлмәк	N
уйнат	V
кипкән	ADJ
китаби	ADJ
бәти	N
шейк	N
кайтадан	ADV
штурмла	V
карышлавык	N
уем	N
ян	V
мәхбүс	N
китеклә	V
ди	V
осетрина	N
сылулан	V
чүп-чар	N
сөкә	N
күрше	N
җирсү	N
туй	N
метанол	N
пластик	ADJ
чөгә	N
порнографик	ADJ
туй	V
косык	N
клевер	N
табигый	ADJ
техникум	N
терчә	ADJ
соскыч	N
утат	V
дәп	PREF_ULTRA
зина	N
төсмерлән	V
тотма	N
атрибут	N
миномет	N
куянчык	N
моторлаштыр	V
коалиция	N
автономик	ADJ
фытыр	N
иҗатташ	N
консерв	ADJ
канцтовар	N
усаллан	V
персонификация	N
ачыклан	V
төркемчә	N
талпын	V
катнаштырыл	V
модельләштер	V
аскорбин	N
гамак	N
керән	N
консилиум	N
көдрә	ADJ
гостиница	N
мөселманча	ADJ
җимергеч	ADJ
бермә-бер	ADVV_NEG
симпатия	N
көлемсерә	V
җен	N
павильон	N
фал	N
чәнчә	ADJ
психоанализ	N
Шндус	N
әвернә	N
карула	V
адрес	N
аргамак	N
шаккат	V
шөшкелә	V
шыгавыл	N
корпоратив	ADJ
җидәүлә	V
станица	N
стресс	N
үзбилгелән	V
башма-баш	ADV
нивх	N
бункерла	V
пролеткульт	N
дранча	N
биата	N
тып	PREF_ULTRA
рикошет	N
пропеллер	N
Шгелек	N
кашын	V
карунлан	V
күбәү	ADVV_NEG
даһи	N
кинематография	N
кетәк	N
эротика	N
оргия	N
күпьяклы	ADJ
пленка	N
декабрь	N
булдырыл	V
бандаж	N
пресс	N
кул-канат	N
ачыл	V
импульсив	ADJ
гранат	N
туа-тумыштан	ADVV_NEG
махинатор	N
окуляр	N
ләим	N
петрушка	N
полистирол	N
калфак	N
я	CNJ
массовка	N
фотокорреспондент	N
дизайнер	N
тәкрар	N
кара-чутыр	ADJ
эфедра	N
рейдтагы	ADJ
чип	PREF_ULTRA
куштан	ADJ
калта	N
эскәк	N
ярка	N
агылҗым	N
чытырдат	V
йонтач	ADJ
панцирь	N
узышлый	ADVV_NEG
якобинчы	N
тигезләмә	N
радон	N
тыгыл	V
янавыч	N
одеколон	N
фырт	ADJ
фол	N
баталия	N
миңгерәткеч	N
хобби	N
шиңдер	V
эчәккуышлылар	N
кечкентәй	ADJ
тарлавык	N
ядкарь	N
юлла	V
кышла	V
сержант	N
киләчәк	N
какофония	N
эшбашкаручы	N
сыерчык	N
сердәш	N
элегрәк	PN
көн	N
командарм	N
олайт	V
яңгырат	V
кыпчакла	V
желе	N
шик-шөбһәле	ADJ
ураган	N
алтынсары	ADJ
юрга	N
стоик	N
җилгер	ADJ
фШл	N
арьергард	N
кикерек	N
больница	N
бөкелән	V
исән-аман	ADJ
пессимистик	ADJ
киоск	N
ромашка	N
йөгерт	V
нечкәр	V
серпентин	N
серкә	N
алмаз	N
даруханә	N
юниор	N
зулу	N
җәдит	N
шомарт	V
бөктәр	N
авыраяк	N
рәте-чираты	N
аударт	V
армада	N
папье-маше	N
гәп	N
сервелат	N
кукуруз	N
Шзгелек	N
күнегел	V
геологик	ADJ
йомарлан	V
чина	V
сагындыр	V
публицист	N
һөҗүм	N
күбәк	N
бәрән	N
бункер	N
кинофикация	N
шөгыльлән	V
көтек	ADJ
бәләклә	V
интеллектуал	N
иләгеч	N
агитацион	ADJ
караула	V
күрше-колан	N
карынкы	ADJ
бәхиллә	V
ко	ADJ
хәллән	V
өйрәнгеч	N
ягымлы	ADJ
бимазала	V
наргилә	N
мөһер	N
хөрмәтлә	V
погранзастава	N
морг	N
какао	N
карамак	N
Шгезәк	N
яндырт	V
шпинат	N
уфла	V
кислотала	V
администрация	N
дага	N
рефлектор	N
номерлан	V
яфрак	N
нәп	PREF_ULTRA
уңайсызлат	V
авыр	ADJ
программала	V
клиндер	N
формация	N
ультратавыш	N
урология	N
котый	N
япма	N
пешерен	V
чиләт	V
электроник	ADJ
галера	N
таянгыч	N
шешенкерә	V
перископ	N
кайнатма	N
төтмәс	ADJ
уйлан	V
диплом	N
сугыш-көрәш	N
төшендер	V
люминесцент	ADJ
сосла	N
бераздан	ADVV_NEG
мәйханә	N
варан	N
аңынчы	ADVV_NEG
карун	N
күк	N
ипи	N
сиплә	V
кәсеп	N
кылтыклан	V
шулпа	N
борчакла	V
хәзер	ADV
интонацион	ADJ
җепсел	N
депеша	N
кыймылда	V
шивә	N
аксыллан	V
дистрофия	N
бШштәр	N
сап	V
совинформбюро	N
кабилә	N
тренер	N
буынтыгаяклылар	N
трактир	N
лактация	N
мелиорациялә	V
чырла	V
апрель	N
паскаль	N
йон-мамык	N
чебен-черки	N
сыгыл	V
үзләштерел	V
чарлан	V
шумер	N
тәлинкә	N
асфальт	N
полиграфик	ADJ
мәлҗерә	V
тасвир	N
мичкә	N
репортер	N
телефонист	N
элмә	N
аптека	N
туган	ADJ
звонок	N
колхозара	ADJ
мәңгегә	ADV
әлиф	N
бөгәрлән	V
капкачла	V
әчәч	N
пикетла	V
шым	ADVV_NEG
ипекәй	N
сихәтлән	V
олимп	N
режим	N
униформа	N
сохари	N
булла	N
кучкар	N
шыгрым	ADV
тугар	V
көлтә	N
пианино	N
вышка	N
рухландыр	V
тасрайт	V
төньяк	N
поши	N
туна	V
талчок	N
автокласс	N
изах	N
һушсызлан	V
кәрәкә	N
сет	N
һинди	N
нисбәт	N
морж	N
мыжла	V
чәчкә	N
тырыш	ADJ
бугазлат	V
Шшәк	N
волокита	N
сүнгән	ADJ
җитдиләт	V
җШбәр	V
санкюлотлар	N
мамзель	N
стилизация	N
Шганә	N
Шртән	ADVV_NEG
неврастения	N
кискеч	N
верфь	N
патронаж	N
фронталь	ADJ
шикәрлә	V
кисел	V
саяк-сандырак	ADJ
чиратла	V
шок	N
штандарт	N
канкан	N
яңгыра	V
җелтерәт	V
бишмәт	N
исти	N
тәңкәләт	V
шәраб	N
фабком	N
күбәү	ADV
нейлон	N
куәтлән	V
савыл	V
эренлә	V
референдум	N
шыпан	ADVV_NEG
гуманист	N
ракурс	N
коп	PREF_ULTRA
кыргаяк	N
хәлиф	N
синонимия	N
чалтыра	V
шыңгыра	V
селтә	V
маевка	N
комфорт	N
фотопленка	N
галиҗәнап	N
шпага	N
чыгынкы	ADJ
	
калдык-постык	ADJ
вазгыять	N
крюшон	N
рулет	N
диаметраль	ADJ
мүк	N
яренгә	ADV
сыйпат	V
колорад	N
вотчина	N
роль	N
үсемлекчелек	N
җиңги	N
тартай	N
алагаемга	ADV
риялан	V
стоматит	N
комсу	ADJ
сектант	N
ритмик	ADJ
рассольник	N
лайлач	ADJ
ыңгыр-шыңгыр	ADV
умарта	N
пырдымсызлан	V
парлыла	V
белгеч	N
пресс-клуб	N
экспрессив	ADJ
спецовка	N
вестибюль	N
статья	N
интерференция	N
катлама	N
исәбе-хисабы	N
метчик	N
концерн	N
кәнди	N
аңгыра	ADJ
утырткыч	N
фамилия	N
кяфер	N
чәпче	V
анаконда	N
ярлыкат	V
сослан	V
фатихала	V
нәсел	N
аукцион	N
боек	ADJ
йөкләмә	N
төкерен	V
логос	N
күренер-күренмәс	ADJ
семинар	N
мобилизациялә	V
ветеран	N
шөкәтсез	ADJ
әңгәмәдәш	N
илә	V
тәнчек	N
падишаһ	N
дамелла	N
ацетилен	N
өй	V
бөдрәләт	V
туй-төшем	N
далай-лама	N
диспут	N
әйтмәк	N
талкы	N
бердәм	ADJ
телә	V
Шдән	N
ябындыр	V
талкы	V
ызгы	V
ир	N
индуизм	N
йодрыклат	V
агарын	V
калайлан	V
заказ	N
бадья	N
китерт	V
темп	N
лампочка	N
җилек	V
эпос	N
гореф-гадәт	N
туран	N
чулак	ADJ
акчәчәк	N
юешлә	V
марля	N
түтәллә	V
реввоенсовет	N
ташбаш	N
ачык	V
дисәтинә	N
тыккысыз	ADJ
җилек	N
сафсата	N
а	ATTR_ABES
гап	PREF_ULTRA
авылдаш	N
гобой	N
яз	V
провинциал	N
тузан	N
ялганма	N
казначей	N
утал	V
чапчак	N
фарш	N
шулар	PN
биостимулятор	N
лаборант	N
яз	N
җәдитлән	V
эсперанто	N
гомеопатия	N
кыстыргыч	N
күп	V
динозавр	N
кабык	N
баббит	N
агрофирма	N
мескенчек	N
әшәкелән	V
инструктаж	N
томанлан	V
каймал	V
расход	N
мулат	N
әрәтә	N
асыл	V
аламалан	V
вакуум	N
булат	N
гольф	N
пәрәнҗә	N
тазарт	V
лама	N
телсезлән	V
карбюратор	N
катаракта	N
алхимия	N
фарыз	N
утрак	ADJ
кемпинг	N
орнитологик	ADJ
җыбыткы	N
конар	N
ил-күз	N
хәлле-хәленчә	ADV
габардин	N
тачка	N
лакировка	N
камин	N
юнәлткеч	ADJ
штамповка	N
семга	N
караим	N
бәдәл	N
драмтүгәрәк	N
коточарлык	ADJ
магазин	N
йогынты	N
агитка	N
стадиаль	ADJ
колониаль	ADJ
кызый	N
белешмә	N
видеомагнитофон	N
һиммәт	N
аләм	N
флорин	N
җәза	N
эгида	N
тапылда	V
шартлаткыч	N
гимнастерка	N
чатнат	V
аунакла	V
парадигматик	ADJ
какы	N
компенсация	N
мистер	N
таз	N
дерелдәт	V
машинка	N
каракүз	N
тагын	V
проекциялә	V
танго	N
антрополог	N
теллә	V
периферия	N
плен	N
гыйлем	N
пычтырда	V
артык-портык	ADJ
шоу	N
вигвам	N
таты	V
ситуацион	ADJ
сур	N
иярлә	V
пилотка	N
кыйсса	N
хәкимдар	ADJ
акрынлык	N
кыз-кыркын	N
филиал	N
киңәш	V
каршы	ADJ
генетик	N
дублер	N
ташбака	N
урынтын	ADV
тәрәккый	N
тек	N
анархист	N
шпунтла	V
националист	N
азиат	N
радионокта	N
бертуктамый	ADVV_NEG
тек	V
мәңгелә	V
очсызла	V
рельс	N
киңәш	N
килеш	N
җәһәтлә	V
хәрби-һава	ADJ
шөреп	N
иксез-чиксез	ADJ
материализм	N
гәҗит	N
каениш	N
җәмәгатьчел	ADJ
демократиялә	V
тәүфыйксызлан	V
хәрәкәтчел	ADJ
гармониялә	V
әзер	ADJ
көрмәклән	V
фитотерапия	N
җентеклә	V
иләм	ADJ
эмбриональ	ADJ
выжлат	V
салла	V
электромонтер	N
терапевт	N
автономия	N
атыл	V
штанга	N
алкушымча	N
логарифм	N
эстетик	ADJ
үткәз	V
чөйязма	N
эһелдә	V
ток	N
хәстәрлә	V
пич	N
ломбард	N
обмотка	N
Шртәләрен	ADV
панисламизм	N
текстуаль	ADJ
альпинист	N
төтәслә	V
трансформациялән	V
тикшеренмә	N
шундук	ADV
сперма	N
грузин	N
йөткер	V
бадән	N
сөзгеч	N
кыйбат	ADJ
региональ	ADJ
фурма	N
кристаллик	ADJ
майтар	V
инсаният	N
итәк	N
каләмдәш	N
йөрердәй	ADVV_NEG
хәзерлән	V
күсәклә	V
чирканчык	N
өстәге	ADJ
гид	N
редуктор	N
бушлай	ADVV_NEG
заказной	ADJ
форейтор	N
киль	N
сыекча	N
мөгез	N
кимендә	ADVV_NEG
лизин	N
Шҗек	N
ялгыш	V
синтез	N
кавыкла	V
кәшемир	N
җилкенсен	V
ялгыш	N
демонстратив	ADJ
мөхәррәм	N
комиссариат	N
ассонанс	N
зодиакаль	ADJ
марксизм	N
карындаш	ADJ
шугалак	N
ныгытма	N
җәһәт	N
яшерен	V
мировой	ADJ
кылтай	V
ай-вайла	V
фабула	N
тикшерен	V
акустик	ADJ
тыңлан	V
хиссезлән	V
сазламык	N
балансла	V
фармакогнозия	N
өстәлмә	ADJ
конверсиялә	V
ачык-тишек	N
кәмит	N
дистәлә	V
күрән	N
атлам	N
интуитив	ADJ
акла	V
сүт	V
ампер	N
максатсыз-нисез	ADJ
контора	N
каһкаһә	N
доломит	N
абый	N
альтруизм	N
менбәр	N
статус-кво	N
ламбард	N
патефон	N
синхроник	ADJ
тузбаш	N
янгын	N
гает	N
фото	N
баҗай	N
штабс-капитан	N
сагын	V
бор	V
автомобиль	N
деривацион	ADJ
ястү	N
купшаклан	V
тактик	N
кыйраәт	N
ия	N
ярымколония	N
бронх	N
карга	V
тукмак	N
төссезлә	V
фарисей	N
түк	V
урт	N
британияле	N
акбалык	N
түк	N
колхоз	N
трансцендент	ADJ
карга	N
петарда	N
сөйкемсезлән	V
мә	N
джип	N
һичшиксез	ADV
күксе	V
прусс	N
кадровый	ADJ
сөрт	V
индукция	N
реквизитор	N
мә	V
мордар	ADJ
устав	N
шапылдавык	N
шакмак	N
кордон	N
шабаш	N
бертуктамый	ADV
тор	V
барий	N
аерымлан	V
шпур	N
киртләчлә	V
хәсрәт	N
лавсан	N
чистарын	V
электр	N
урысчалат	V
мосье	N
космографик	ADJ
радиостанция	N
кәрләч	N
чырагач	N
төшер	V
туемсызлан	V
рейка	N
хәтсез	ADV
мастеровой	N
койты	ADJ
партоешма	N
хәрбилә	V
пролетка	N
комплектла	V
кузгат	V
алкы	V
гамма	N
повестка	N
үтәт	V
папаверин	N
берсе-бер	PN
пассажир	N
мирза	N
шүрлек	N
аномалия	N
парүлчәгеч	N
онта	N
байдарка	N
дә	V
каша	V
океан	N
лафет	N
сумса	N
дамба	N
почтамт	N
автотранспорт	N
хиппи	N
юстиция	N
марена	N
өстәлдәш	N
дә	N
крона	N
хәйран	ADJ
портвейн	N
онтология	N
опекун	N
кабер	N
шлюз	N
талисман	N
справка	N
тигезләгеч	N
нәсел-ыру	N
колбаса	N
тәрбия	N
сөзәгәй	V
әткәй	N
көдрәләт	V
зоотехника	N
кенаф	N
гатырша	N
мобилизация	N
экзистенциализм	N
тылмач	N
генерал-лейтенант	N
томау	N
апоплексия	N
шалтыравык	N
витрина	N
мутла	V
фантазер	N
идеографик	ADJ
хлорофилл	N
аз-азлап	ADV
эпопея	N
кардинал	N
чатлы-ботлы	ADJ
тигәнә	N
кавалер	N
героик-романтик	ADJ
инкыйлап	N
аппозитив	ADJ
шәлпек	ADJ
күчмә	ADJ
политуку	N
позывной	N
көләч	ADJ
хөртилән	V
пастеризатор	N
мөселман	N
атеизм	N
санитарка	N
дулкынлан	V
симметрик	ADJ
тәкәбберлән	V
карарла	V
пеленг	N
нейтрон	N
штапель	N
георазведка	N
шөллә	V
юма	ADJ
йотык	V
сөмсез	ADJ
кустарь	N
дәкыйка	N
спин	N
хәзергә	ADVV_NEG
туклан	V
ниятлә	V
каләм	N
тотыш	ADJ
берөзлексез	ADVV_NEG
скептик	N
Шсәнлек-саулык	N
бәсәр	V
сөлге	N
тәмам	N
көрмәклә	V
чагыл	V
трек	N
гидромеханика	N
профессиональ	ADJ
коел	V
ышкыл	V
девон	N
психиатрия	N
дуалистик	ADJ
киңәшмә	N
йөрәкчек	N
ванилин	N
гипотония	N
рәшәлән	V
фоторепортаж	N
ләса	N
этика	N
күч	N
модернизациялә	V
курыс	N
априори	ADV
карамала	V
алмаш	V
арго	N
монастырь	N
сагызла	V
мал	N
белексез	ADJ
иске-москы	N
алмаш	N
ишкәк	N
редактор	N
хореография	N
шушындый	PN
төрт	V
сыпыр	V
пошкыр	V
барырдай	ADVV_NEG
бабай	N
триумф	N
модель	N
трактовкала	V
философик	ADJ
тәбриклә	V
нут	N
биләүсә	N
факел	N
чит	ADJ
параграф	N
теннис	N
өлешлә	V
лексикология	N
өстер	V
урлат	V
купол	N
тамада	N
тотем	N
шатырда	V
үрлә	V
төк	N
бюрократия	N
бром	N
рецидивист	N
пакетбот	N
домино	N
кертел	V
артериосклероз	N
букинист	N
мәсхәрәлә	V
бастион	N
финанс-кредит	N
яңак	N
туймас	ADJ
проект	N
геометрия	N
ишет	V
нәсер	N
фәһемлә	V
штурмовик	N
кушуч	N
саубуллаш	V
ликпункт	N
берән-сәрән	ADV
сымак	PN
кәкрәй	V
еврей	N
шартнамә	N
новелла	N
чор	N
анестезиолог	N
себерт	V
палеонтолог	N
иҗтимагый	ADJ
айбалык	N
какла	V
болгавыр	ADJ
бүлмәдәш	N
шимали	ADJ
туендыргыч	N
тегенди-мондый	ADJ
полпредлык	N
прозаик	N
лавка	N
гармун	N
сызгы	N
келәщә	N
психик	ADJ
таманлан	V
кальцит	N
урман-тундра	N
хикәялә	V
колакла	V
телефонлаштыр	V
сап	N
мадонна	N
габи	ADJ
аерата	ADV
һәрдаим	ADV
экспансия	N
касык	N
редут	N
наян	ADJ
англосакс	N
диярлек	ADV
күбә	ADJ
яхшылат	V
ахирәт	N
искәрмә	N
көлчә	N
мәсләк	N
чәчтараш	N
дерелдек	N
анонимка	N
мотовелосипед	N
яхшырт	V
үтер	V
үги	N
форель	N
әшәкеләт	V
соргылтлан	V
чупылдат	V
түтәрәм	N
иңсә	N
күмәрлә	V
фармацевт	N
мыжык	ADJ
дөмбердә	V
мозаик	ADJ
ышыклагыч	N
үрәчә	N
кайры	N
алабута	N
ими	N
тиктомалдан	ADVV_NEG
крепостной	N
чорнал	V
аметист	N
чөңгер	V
вулканик	ADJ
экспрессионистик	ADJ
тыңкыш	ADJ
гадәт-холык	N
тарихи	ADJ
перчатка	N
даргин	N
арышбаш	N
кофе	N
биржа	N
нәзафәт	N
азгынлан	V
кадәр	PN
усак	N
ветперсонал	N
җирән	V
йоттыр	V
студент	N
карбикә	N
мыгырдан	V
стрептоцид	N
алаштыр	V
әрлә	V
чарылдык	N
ыргы	V
ук	N
залог	N
карт	ADJ
тамыз	V
рәис	N
алым	N
җип	PREF_ULTRA
уба	N
йолдызчык	N
кискенлә	V
уникаль	ADJ
амбразура	N
ашлык	N
бибек	N
натурализм	N
йорт	N
ярлылан	V
чачаклы-чуклы	ADJ
хосусый	ADJ
мөнәҗәт	N
органика	N
ром	N
ач-ялангачлык	N
рута	N
улак	N
эндогам	ADJ
таможня	N
ничәләп	PN
акробатик	ADJ
кызылча	N
ярәш	V
төртен	V
җария	N
стенографик	ADJ
сиптергеч	N
ялгызак	ADJ
бүзәр	V
плед	N
тартмачык	N
реконструктив	ADJ
сакла	V
утыргыч	N
битум	N
атаман	N
тут	N
социалистик	ADJ
шигрин	N
агыл	V
алмаштыр	V
термик	ADJ
бШтлә	V
сос	V
чепи	ADJ
табун	N
өземтә	N
ярмалан	V
грамота	N
зурна	N
иррациональ	ADJ
җылы	ADJ
сабырлан	V
тукмаклат	V
җанкисәк	N
сынык-сынык	ADJ
химизация	N
югын	V
борчы	V
ахак	N
эскиз	N
челәй	V
от	V
петлица	N
маклер	N
кыткылда	V
реплика	N
йоклан	V
мәҗлес	N
бүл	V
солдатка	N
лампа	N
яка	N
транзистор	N
шомрайт	V
пики	N
кәлимә	N
карал	V
сингармоник	ADJ
яучыла	V
амин	ATTR_ABES
әй	ATTR_ABES
кыйшыклык	N
контрабандист	N
коммюнике	N
челтерә	V
экономик	ADJ
тырпылда	V
реанимация	N
зәһәрлән	V
үрләт	V
сөяк-саяк	N
комета	N
самавыр	N
дыңгылда	V
концертмейстер	N
дулкынлат	V
хосусан	ADVV_NEG
ыштан	N
чирләшкә	ADJ
аждаһа	N
лицей	N
тала	V
күп	ADJ
театраль	ADJ
биздергеч	N
зубр	N
кайне	N
вә	CNJ
монархист	N
большевиклаштыр	V
саквояж	N
элемент	N
очко	N
катакомба	N
отыры	ADV
су	ADJ
портсигар	N
типовой	ADJ
топ	PREF_ULTRA
яртышар	ADVV_NEG
сызык	N
баналь	ADJ
фотомонтаж	N
чынбарлык	N
моторист	N
Шрек	N
регион	N
чытлыклан	V
толым	N
стачка	N
хат-хәбәр	N
актыккы	ADJ
әбелхәят	N
Шскәр	V
шәңгә	N
мемориал	N
наркозла	V
хикәялән	V
күз	N
Шрек	V
вакантлы	ADJ
челтәр	N
мәзһәп	N
корвалол	N
чыдат	V
урыс	N
реализациялә	V
моторка	N
рапс	N
мөнбәр	N
тураклан	V
илгәзәклән	V
пеленгатор	N
мескенкәй	N
Шлкүләм	ADJ
кадими	ADJ
гейзер	N
җәберсет	V
фуражка	N
телерепортаж	N
матәм	N
тибрә	V
шишара	N
сәүдәлә	V
артым	N
алсу-кызыл	ADJ
үлемтек	N
педагогика	N
гимн	N
кикер	V
бали	ADJ
куплет	N
парча	N
кисем	N
чолан	N
мөстәкыйль	ADJ
сорго	N
гипофиз	N
карчык-корчык	N
мазохизм	N
торак	N
экипаж	N
болгар	N
шупырда	V
төс	N
көнгерә	N
дуадак	N
тырышып-тырмашып	ADVV_NEG
әүмәклән	V
тун	N
миграцион	ADJ
бөтәй	V
җәнүби	ADJ
алтынсула	V
тимерлә	V
ыргыт	V
кушак	N
күчән	N
чокы	V
эчкәреге	ADJ
чаган	N
демографик	ADJ
мирас	N
бәдрәф	N
флирт	N
талант	N
дерелдә	V
ихтирамла	V
дучмак	N
Шнструктор	N
зарурият	N
уфылда	V
лот	N
километр	N
шедевр	N
тәлләтәвеч	N
Шртәнгә	ADVV_NEG
бозаула	V
флектив	ADJ
хан	N
рогатка	N
ир-егет	N
протекционизм	N
уругвайлы	N
балачак	N
кәфенлә	V
кырдырт	V
шыкылдат	V
башкарыл	V
гуталин	N
алдап-йолдап	ADV
гинеколог	N
Шзопрен	N
камзул	N
инвестиция	N
бобрик	N
мимылда	V
экскурсион	ADJ
погон	N
публикация	N
слива	N
булдыр	V
эскадрилья	N
җомга	N
юна	V
җек	N
рулетка	N
ишекчә	N
полковник	N
кристалла	V
хыяллан	V
шәрәфле	ADJ
шәһәрчек	N
александрит	N
байгура	N
экспрессионист	N
сәяси	ADJ
чулаклан	V
мулине	N
гомуми	ADJ
җәнҗал	N
фара	N
түтШ	N
дая	N
ординарец	N
каравыш	N
шыкылда	V
кортла	V
карачкыл	N
илер	V
сөйкән	V
индивидуалистик	ADJ
исе-җиле	N
автобус	N
әнкәй	N
эвристик	ADJ
фаҗига	N
кинодраматургия	N
пошыр	V
венгр	N
кайна	V
тишкәлән	V
мәкер	N
прототип	N
лингвистик	ADJ
ишле-кушлы	ADJ
секреция	N
күренексез	ADJ
фидия	N
нота	N
эшмәкәр	N
кәнитил	N
шаһәдәтнамә	N
гөбәдия	N
тапла	V
кавыштыр	V
бабасыр	N
абстракция	N
күзле-башлы	ADJ
камус	N
хатын	N
шиферла	V
земство	N
йөрем	N
препарат	N
коряк	N
орнитолог	N
Шхтыяр	N
документация	N
котлован	N
карабах	N
контрчара	N
Шләк	N
җитдият	N
аркылы-буйлы	ADJ
кордаш	N
нитрат	N
жаргон	N
синхрония	N
балак	N
забой	N
тизәйткеч	N
бугаз	N
патиссон	N
баул	N
девальвация	N
сәмән	N
үксет	V
тапа	V
татлан	V
тахта	N
катлаулан	V
ишәй	V
бәла-каза	N
конвой	N
тавыш-гауга	N
үрт	N
нәүмиз	ADJ
установка	N
ярут	N
ияр	N
фәлән-фәсмәтән	N
манускрипт	N
риза	ADJ
шатранҗ	N
монизм	N
ияр	V
тулысы	N
яубашы	N
лотерея	N
биртел	V
автобиография	N
рәсүл	N
перламутр	N
йолдызара	ADJ
бавыр	N
шарлавык	N
сәләт	N
уңган	ADJ
сеңлең	ADV
стан	N
баронесса	N
ялмавыз	N
зеландияле	ADJ
шлемофон	N
трамплин	N
мадам	N
аерылмыш	N
мәлгунь	ADJ
шаман	N
бушлай	ADV
баттерфляй	N
фломастер	N
мивә	N
кооптация	N
суйдыр	V
картечь	N
ландрин	N
лыгырда	V
чулпы	N
теләктәш	N
коммунистик	ADJ
ковбой	N
каберстан	N
дулат	V
шан	N
банту	N
дружина	N
сугару	N
ядәч	N
кич	ADV
күчәрлә	V
әлеге	ADJ
яренгә	ADVV_NEG
киноаппарат	N
сталактит	N
кыйгакла	V
әзмәвер	ADJ
хиромант	N
суктыр	V
кучер	N
кыргый	ADJ
универсаль	ADJ
клей	N
Шнвестор	N
рәтлән	V
криминалистика	N
селәүчән	N
заманалаштыр	V
белем	N
акцентлаштыр	V
автосалон	N
гиз	V
курфюрст	N
дини	ADJ
планировка	N
новатор	N
ябылу	N
азимут	N
оҗмах	N
ипподром	N
күм	V
#lem	#lex
ымсын	V
принцесса	N
нәзеклән	V
маймыллан	V
чытырда	V
бүкән	N
меньшевизм	N
суүсем	N
бул	V
чәбәкәйлә	V
үткәргеч	N
читек-кәвеш	N
төркилә	V
кырлыган	N
эпитафия	N
позицион	ADJ
әфтияк	N
әкрен	ADJ
репатриант	N
атрибутив	ADJ
салават	N
шөгыль	N
верстка	N
интрига	N
вентиляциялә	V
кәләш	N
низам	N
бастыргыч	N
милли	ADJ
ачылма	N
җиллә	V
плагиат	N
чыбыркыла	V
атропин	N
кәсер	N
мошенник	N
түгәрәкләт	V
җилпердә	V
егерме	NUM
чуерташ	N
мутлан	V
сегмент	N
әсас	N
контрабас	N
хәдШс	N
инсан	ADJ
акбүз	ADJ
чалтыр	ADV
очкак	ADJ
эскадрон	N
шнапс	N
алеут	N
битараф	ADJ
наркоман	N
шунлык	N
мегагерц	N
вотяк	N
гөргелдә	V
рацион	N
сүзлә	V
барьер	N
транзит	N
кантарла	V
артдивизион	N
Шңкү	ADJ
ироник	ADJ
компромисс	N
үткәрел	V
йөдәт	V
бизнес	N
эчкерсез	ADJ
Шлһамлан	V
Шшкәк	N
алгоритм	N
тол	ADJ
баштарак	ADVV_NEG
тырнат	V
мөхбир	N
бәбчек	N
претензия	N
радиус	N
матрица	N
иравыл	N
коңгырт	ADJ
мин-минлек	N
тополь	N
анафора	N
кегель	N
политинформация	N
җәрәхәт	N
тармаклан	V
диләнке	N
батырай	V
делянка	N
географ	N
заем	N
симбиоз	N
сыла	V
слалом	N
шаш	V
федератив	ADJ
үрәчәлә	V
кулуар	N
җемелдәт	V
күрек	N
чишел	V
тылкыш	V
сакау	ADJ
кинофестиваль	N
аһла	V
шадралан	V
халыкла	V
алебастр	N
хәрәмлә	V
кызыктыргыч	ADJ
ветсанитар	N
пани	N
чигер	V
президиум	N
антоновка	N
сурәт	N
күпьеллык	ADJ
белдексез	ADJ
убыр	V
белдеклелән	V
ялтыр-йолтыр	ADJ
дүңгәләк	N
титан	N
бир	V
кубыз	N
кайрыла	V
көзән	N
ут-күз	N
археологик	ADJ
адаштыр	V
дөмек	V
хосусән	ADVV_NEG
убыр	N
аңарчы	ADV
педаль	N
музыкант	N
янә	ADVV_NEG
мамык-йон	ADJ
мәдәт	N
прицеп	N
значок	N
козгын	N
яулык	N
урак-чүкеч	N
оппозиция	N
осетр	N
акация	N
малтабар	N
аммиак	N
оракул	N
экс-чемпион	N
кайраклан	V
карфагенлы	N
гайре	ADVV_NEG
хәтсез	ADVV_NEG
электроника	N
зөбәрҗәт	N
тудык	N
бокс	N
хәләл	ADJ
йоп	PREF_ULTRA
экспозиция	N
тугыз	NUM
инкяр	N
бюргер	N
тасвирла	V
сыңар	ADJ
корабль	N
шәһәр	N
Шртәләрен	ADVV_NEG
мотлакан	ADJ
чолга	V
вә	N
телепат	N
карбон	N
консорциум	N
арфа	N
формаль	ADJ
демобилизациялә	V
сукырай	V
көт	V
шыркылда	V
нәҗәгай	N
сүрел	V
олы	ADJ
ресурс	N
вә	V
мелиоратор	N
фәкыйрьлән	V
счетка	N
экспрессивлык	N
доход	N
коммутатор	N
ацетат	N
туганнар	N
конгломерат	N
каллиграф	N
данә	N
антитәнчекләр	N
семестр	N
каре	N
метранпаж	N
суса	V
нахал	N
каене	N
нанай	N
әкренлә	V
заправка	N
тезгенлә	V
йомрыла	V
удел	ADJ
керәнлә	V
соңлат	V
сапфир	N
әрсезлән	V
микроб	N
радикализм	N
газик	N
кымшан	V
пафос	N
маркировка	N
бакылда	V
язык	N
ямьсезләт	V
шөкрана	N
рангоут	N
демократизм	N
өйрәтел	V
сылтан	V
неолит	N
реорганизациялә	V
йотлык	V
феодаль	ADJ
анализатор	N
очар	ADJ
урындык	N
фокстрот	N
азыклан	V
талия	N
сәяхәтнамә	N
мангуст	N
катыйль	ADJ
куаныч	N
артистка	N
бюджет	N
таптан	V
пауза	N
җен-пәри	N
леди	N
үксез	N
абага	N
трибун	N
каен	N
Шнабәт	N
литвалы	N
үзәклә	V
карый	N
белгән-белмәгән	ADJ
фантазия	N
чишендер	V
семафор	N
тоннель	N
мамык-җеп	N
сурәтләмә	N
рухШ	N
югал	V
антик	ADJ
угыч	N
лимфатик	ADJ
сөрсе	V
ызан	N
суперфосфат	N
магистр	N
дин	N
гайрәт	N
сыкрат	V
аҗаган	N
бәргеч	N
трагизм	N
тамырдаш	N
гадәт	N
патриархия	N
маршал	N
мичуринчы	N
саттыр	V
гүзәллән	V
тир	N
уран	N
модификация	N
семья	N
качыр	N
чыгышлый	ADVV_NEG
туганкай	N
балаган	N
үзән	N
күпбуын	N
индивид	N
тазарткыч	N
сантиметрла	V
такса	N
корал-ярак	N
хронометр	N
о	N
саклагыч	N
бестселлер	N
кимендә	ADV
нюанс	N
виза	N
экстремист	N
Шм-том	N
гөлбаба	N
эстрада	N
гөблә	N
психологик	ADJ
яхта	N
имгәт	V
куыл	V
сепаратизм	N
аңкы	V
квадратура	N
казах	N
мазасызла	V
Шшетел	V
чап	V
ябалдаш	N
вәсвәсәлән	V
канкойгыч	ADJ
гастрит	N
троллейбус	N
тәңре	N
лапас	N
уролог	N
бронь	N
трубопровод	N
соп	PREF_ULTRA
мул	ADJ
тюбинг	N
үле	ADJ
позитив	N
кабарынкы	ADJ
катапульта	N
шиклән	V
фон	N
дебют	N
битәрләт	V
итәк-җиң	N
җыерча	N
мизансцена	N
коры	ADJ
укбаш	N
чыпылда	V
зәңгәрлән	V
визитка	N
кытайчалап	ADV
яралы	N
реквизиция	N
урама	N
пәрдәлән	V
сипкел	N
экватор	N
дипломант	N
кыдрач	ADJ
гегемон	N
замша	N
җисмани	ADJ
әтШ	N
мияубикә	N
оекбаш	N
колорит	N
белуга	N
прогимназия	N
ястык	N
төймәлә	V
балдакла	V
хилаф	ADJ
ятак	N
схема	N
тәкатьсезлән	V
заставка	N
утилитар	ADJ
Шген	N
трампарк	N
алиһә	N
төшерелмә	ADJ
Шнсан	ADJ
русификация	N
күзчек	N
нимфа	N
эдельвейс	N
бандероль	N
мендәрчек	N
Шмпотент	N
партактив	N
тәмамла	V
фирма	N
берсекөн	N
пилорама	N
контейнерла	V
юнга	N
орхидея	N
шарлатан	N
ләм	N
подагра	N
әчелән	V
бурят-монгол	N
чар-нәчар	ADV
генштаб	N
пырдымсыз	ADJ
чуптар	N
агула	V
карсак	ADJ
борлык	V
үткенләт	V
штурвал	N
бәк	N
тияре	N
мануфактур	ADJ
гырылдавык	N
унөч	NUM
реактив	N
спиннинг	N
радиотыңлаучы	N
тирбәлә	V
монарх	N
әдәби	ADJ
йөзгеч	N
тәүфыйк	N
оптик	ADJ
балласт	N
эмульсия	N
гиперболик	ADJ
аңсызлан	V
низагла	V
калынайт	V
чапрак	N
ихахайла	V
кыяфәтнамә	N
фарватер	N
торым	N
дозор	N
испан	N
әче-төче	N
Шлгәзәк	N
национализациялә	V
печән	N
дулкын	N
терсәк	N
катрә	N
куәтлә	V
перфорация	N
каксыт	V
биофизик	N
кәләвә	N
усал	ADJ
чәйханә	N
вентилятор	N
сыптыр	V
идән	N
инглиз	N
солистка	N
эпохаль	ADJ
мат	N
пентатоника	N
бутал	V
әрлән	N
ялтырак	N
ярымшар	N
төтенсу	ADJ
декор	N
шигырь	N
тәпи	N
әрлән	V
табышмак	N
шагыйрә	N
җиткер	V
җилкән	N
сыткы	N
үтәдән-үтә	ADVV_NEG
сабынлан	V
кинжал	N
уйдырма	N
мыскалла	V
кылыч	N
җырлан	V
икенде	N
адаш	V
күпер	N
тәнкыйди	ADJ
мәхдүмә	N
күпер	V
йөзьяшәр	N
кисточка	N
эвкоммия	N
нетто	N
стенография	N
иллюстрациялә	V
тәкбир	N
күкбаш	N
бытылда	V
радикал	N
адаш	N
вәсвәсәче	N
чалшай	V
фрагментар	N
карлик	N
галим-голәмә	N
алышын	V
сеньор	N
наряд	N
подтяжка	N
чуарлан	V
курант	N
дәррәү	ADV
пропуск	N
чалкан	ADV
инкубатор	N
вездеход	N
шулай	PN
гариплә	V
гаолян	N
унсигез	NUM
энҗелә	V
пингвин	N
әйтелмә	N
дәвалан	V
трапеция	N
ирригация	N
никахла	V
дурчмак	N
остабикә	N
иблис	N
термодинамика	N
абруй	N
бихисап	ADV
электрод	N
эклектика	N
валерьянка	N
синхрон	ADJ
барыбер	ADVV_NEG
диспансер	N
этник	ADJ
сакаулан	V
тат	N
киңәшлә	V
апатия	N
шнек	N
гаурәт	N
төннәләтеп	ADV
кырмавык	N
әвен	N
пожар	N
максатчанлык	N
ятимә	N
кансыра	V
дистрофик	ADJ
посылка	N
кулинар	N
түбәнчелек	N
әйберлә	V
Шгәүлә	V
калач	N
интерес	N
магнезия	N
җәфа	N
күбәй	V
ярсы	V
чүкет	V
пошыргалан	V
кылтырат	V
рационализм	N
борычла	V
авыштыр	V
коррелят	N
коммерсант	N
мистификация	N
көчәйт	V
заман	N
йомак	N
отчет	N
кискә	N
Шхсан	N
эттер	V
көянтә	N
эстетика	N
шеф-повар	N
хафалан	V
чәрдәклән	V
иртәнгә	ADVV_NEG
ассоциатив	ADJ
пенсия	N
кылычла	V
бөтенәй	V
бушбугазлан	V
свастика	N
яссы	ADJ
концентрациялә	V
олиф	N
элпә	N
пассаж	N
көрәштәш	N
патент	N
актүш	N
артезиан	N
чемче	V
февраль	N
шудырма	N
быгырда	V
атланмай	N
сикерт	V
ябыштыр	V
сферик	ADJ
зынҗыр	N
инсульт	N
энекәй	N
җанкисәр	N
ипохондрия	N
алтынлат	V
калуга	N
бәтилә	V
стилистика	N
тәкрарла	V
бернәрсәсез	ADJ
терлек-туар	N
каршында	ADJ
залп	N
көчек	N
аттестат	N
төнозын	ADV
ончыл	ADJ
трансплантация	N
мыскыл	N
атлык	V
сәхШфә	N
эстон	N
йөзтүбән	ADVV_NEG
сыр	V
ацетон	N
Шшан	N
контузия	N
очырткыч	N
фетиш	N
сибен	V
кая	PN
ваклан	V
кырынла	V
тәтелдәвек	N
өскуйма	N
кузов	N
бертуктаусыз	ADV
дәлШллә	V
укшы	V
водород	N
эгоист	N
отбой	N
вәзШр	N
котырын	V
критикан	N
охшат	V
төзел	V
мажор	N
тайгалак	ADJ
антифашистик	ADJ
бөлдергеч	ADJ
модернист	N
каенигәч	N
лаләчәләр	N
гөрелте	N
ботак-сатак	N
спринтер	N
тәҗрибә	N
сыйныфташ	N
читләт	V
стажер	N
телсез-өнсез	ADJ
вахта	N
каламбур	N
чүкеч	N
вахтман	N
җыем	N
какылда	V
гыжылда	V
формалин	N
панталон	N
шопырда	V
гавай	N
дегустатор	N
ыжгырт	V
мыраубикә	N
драпировка	N
көрсен	V
быкырдык	ADJ
тату	ADJ
бойскаут	N
нәни	ADJ
пурист	N
әүвәле	ADJ
мәктәптәш	N
суспензия	N
тырна	V
батым	N
дельфин	N
тел	N
канәгатьлән	V
утыр	V
данла	V
ага	N
бШл	N
яктылан	V
Шртәгәдән	ADV
иртәгәге	ADJ
үлек	N
юмала	V
нокта	N
чөгендер	N
тел	V
пролетарий	N
телескопик	ADJ
паника	N
көрәй	V
ялкынсын	V
мәсьәлә	N
уптым	ADVV_NEG
бекас	N
масса-күләм	ADJ
хрестоматия	N
кинорежиссер	N
тюльпан	N
зурайт	V
диспепсия	N
кавыз	N
тавыш-тын	N
әмер	N
схематик	ADJ
сер	N
килеш-килбәт	N
ломовой	ADJ
быел	ADVV_NEG
мәхрүм	ADJ
генераль	ADJ
аңгы-миңге	ADJ
шә	N
лангобард	N
строфа	N
зонт	N
кандидат	N
рабфак	N
хирург	N
инсаф	N
тунец	N
башбаштаклан	V
штурман	N
шор	N
бурычлан	V
керәшен	N
шобага	N
истерика	N
күксел	ADJ
тоҗыр	V
раслат	V
сыза	N
борынчык	N
сионист	N
гурман	N
йөзбашы	N
кириллица	N
ротный	N
плюс-минус	N
фактор	N
кытат	N
аркала	V
дискредитациялә	V
акай	V
корсаклан	V
цементла	V
татарчала	V
уылда	V
лилипут	N
сырлан	V
каракорт	N
бард	N
читек	N
стоматолог	N
кипарис	N
термит	N
кайгы	N
эскәмия	N
агым	N
магистраль	N
кузгалт	V
сыдыр	V
чырылдык	N
конфет	N
протеже	N
грузовик	N
тегелмә	N
сәйран	N
литр	N
сыйла	V
искече	N
тональ	ADJ
чуалчыклан	V
сандык	N
дөреслә	V
каргат	V
яртышар	ADV
башмак	N
карат	N
кызалак	N
аркалан	V
цензор	N
стартер	N
кабат	ADV
концепт	N
ветврач	N
мөгрә	V
кушыр	V
лапта	N
яссу	N
коллективлык	N
чәчүргеч	N
яу	N
агрономия	N
молибден	N
җилдәк	N
пружиналан	V
назарият	N
буягыч	N
көнүзәк	N
креп	N
масай	V
попечитель	N
өйрәнел	V
өшән	V
сабырай	V
ригая	N
түбәндәге	ADJ
исламият	N
аяз	ADJ
табан	N
ишарәлә	V
бизон	N
вульгар	ADJ
арт	ADJ
лейтмотив	N
декламация	N
яратырдай	ADVV_NEG
паштет	N
буранла	V
чаптырдат	V
мом	N
полька	N
самурай	N
рулевой	N
лепердә	V
гыйлавә	N
трио	N
бөре	N
арт	V
чатма	N
вак-вак	ADJ
кыргын	N
волюнтарист	N
минут	N
тырнал	V
бусага	N
сайлат	V
тамырча	N
тереләй	ADVV_NEG
валерьян	N
чарльстон	N
диалектизм	N
ияк	N
Шрен	N
психоз	N
этажерка	N
шыр	ADVV_NEG
эзлә	V
Шрен	V
упкын	N
дуплет	N
резонанс	N
үртән	V
тора	N
киресе	N
буынлан	V
сельдерей	N
лецитин	N
социология	N
препаратор	N
путч	N
сал	N
шимбә	N
бетмәс	ADJ
гыйбадәт	N
алпавыт	N
дегетлә	V
гамь	N
сулат	V
ханша	N
пишкадәм	N
тост	N
герцог	N
җанкыйгыч	N
җәмгы	PN
болганчыклан	V
бШр	V
тирәлә	V
лексика	N
массив	N
очрак	N
курсташ	N
чатыр	N
каңгыр	V
дозиметрия	N
төтәч	N
фляга	N
фасон	N
эбонит	N
шах	N
сепаратчы	N
сенбернар	N
каннибализм	N
җөрьәтлән	V
гетера	N
бөтәрлә	V
керләт	V
бирка	N
физзарядка	N
бШстә	N
раса	N
такырбаш	N
Шске-москы	N
женьшень	N
оят	N
яраклы	ADJ
озынчала	V
казылма	N
кадерлән	V
морошка	N
шелтәлән	V
тилмер	V
әсирлән	V
кысык	ADJ
имәнсәр	N
браслет	N
өрәк	N
дуст	N
төплән	V
чаялан	V
чыркылдат	V
дәфтәр	N
аһ-зар	N
эч	N
җилкет	V
укырдай	ADV
шалаш	N
поднос	N
тюбик	N
киноартист	N
снаряд	N
чәчмә	ADJ
клоака	N
төш	V
болар	PN
сажин	N
иҗтиһат	N
колакчык	N
ялгаган	ADJ
сингармонизм	N
тавыштоткыч	N
әрбә	N
өрелмәле	ADJ
тәвә	N
луза	N
төш	N
лесхоз	N
кайнаткыч	N
көне-төне	N
концентрик	ADJ
абсурд	N
поташ	N
чепилән	V
пәрмә-пәр	ADV
агар	V
килька	N
там	V
атбагар	N
солянка	N
шөшле	N
кысала	V
рәсем	N
плато	N
йөз	NUM
лейкоз	N
трикотаж	N
экскурсовод	N
лаг	N
ремонтлат	V
каптырмала	V
океанология	N
стакан	N
чалыш	ADJ
чебиләт	V
ялгат	V
реформалаштыр	V
күбен	V
сәндерә	N
ара	N
парник	N
таман	ADJ
айравык	N
татула	V
алма	N
санал	V
деспотизм	N
ипекакуана	N
лШ	N
рәшә	N
ур	V
абонент	N
гый	N
яхшысын	V
агачлан	V
импотенция	N
муниципаль	ADJ
академия	N
укыт	V
әр	N
плац	N
антагонистик	ADJ
тара	N
паразитизм	N
шыелдат	V
төбе-тамыры	N
дислокациялә	V
чама	N
гөжелдә	V
брандспойт	N
сувенир	N
әкәм-төкәм	N
экспроприациялә	V
кабыз	V
туфли	N
аталан	V
политехникум	N
сукала	V
зуп	PREF_ULTRA
кырый	N
мыекча	N
чолык	N
шапылда	V
чыбыркы	N
салулы	ADJ
мөтәвәлли	N
крокодил	N
низамнамә	N
кештәк	N
кавырсын	N
кларнет	N
чигел	V
ютәлләт	V
сөйкемлән	V
селен	N
карасу	ADJ
драгун	N
почкак	N
төслә	V
тоткыч	N
маникюр	N
сыйпа	V
инсулин	N
чумыр	V
туалет	N
коллективизация	N
мәгариф	N
таранла	V
пыскы	V
кварта	N
пифагорчы	N
тешлә	V
йонлач	ADJ
ташы	V
төркем	N
мөслим	N
серкәлә	V
төнәт	V
өзек-төтек	ADJ
деталь	N
эссеист	N
прописка	N
кыенайт	V
төрчә	N
милек	N
муентык	N
кыскыч	N
текер-текер	ADV
туплавык	N
калыпла	V
патриотизм	N
хәрбШ	ADJ
чукот	N
таш	N
елт	ADVV_NEG
продюссер	N
бизәк	N
үткерлән	V
татуировка	N
чәлдер	V
мөфти	N
төн	N
пыскыт	V
тендер	N
кальга	N
азын	V
Шспәрәк	N
кайчак	ADV
ботак-чатак	N
счетовод	N
куб	N
Шң	N
чуалчык	N
көдрәлә	V
мәсләктәш	N
алгебра	N
буханка	N
вазифа	N
отышханә	N
шаула	V
торос	N
кредит	N
нуклеин	N
секретариат	N
констант	ADJ
туңкайт	V
ладан	N
яклат	V
томыл	V
лакей	N
курык	V
сәргаскәр	N
квантла	V
политбеседа	N
сШхәт	N
фотогазета	N
энциклопедик	ADJ
томала	V
яхшылан	V
райком	N
үтешли	ADVV_NEG
кШ	V
бөкләм	N
ассенизатор	N
рефрен	N
тәкелдә	V
шаянлан	V
сулан	V
рифмалан	V
исәп-хисап	N
алтмыш	NUM
мелисса	N
гирлянда	N
саркома	N
кагылма	N
строй	N
урта	N
ватерлиния	N
телчәнлән	V
артиллерия	N
табло	N
дисциплина	N
солтан	N
иплә	V
бронхиаль	ADJ
гальванопластика	N
га	N
мәтәл	V
элмәклә	V
вепс	N
сиам	ADJ
тарсылда	V
күзмә-күз	ADVV_NEG
шара-бара	N
бары-югы	N
гаҗиз	ADJ
канализация	N
боҗыр	N
хәбәрдар	ADJ
стажировка	N
геолог	N
вәзен	N
салют	N
пюре	N
көчсезлән	V
квалификация	N
бакалавр	N
йомыш	N
сулла	V
ант	N
окоп	N
челтәрлән	V
калтыра	V
милади	ADJ
очык	N
әфлисун	N
када	V
чәчкеч	N
хур	ADJ
лычкылда	V
сирәк	ADJ
төял	V
чәч	N
экстаз	N
очыр	V
комбриг	N
алты	NUM
башла	V
чәч	V
кармавыч	N
уентылан	V
бәс	N
автомат	N
подстанция	N
җикерен	V
трагикомик	ADJ
сагалдырык	N
пулат	N
соңыннан	ADVV_NEG
калтай	V
кальмар	N
кысынкы	ADJ
бояр	N
коллаборационизм	N
асламчы	N
иртәгәдән	ADVV_NEG
аһәң	N
лыч	ADV
импульс	N
изоглосса	N
ул	N
манас	N
йөткерек	N
союз	N
чүмеч	N
кап	V
мюзикл	N
купшылык	N
иммиграция	N
юш	ADVV_NEG
фен	N
гротеск	N
курган	N
уйчанлан	V
суфШ	N
изопрен	N
архипелаг	N
уймак	N
туйла	V
иялән	V
аранжировка	N
иртәдән	ADVV_NEG
липаза	N
палаталь	ADJ
сеңлең	ADVV_NEG
предикат	N
Шран	N
кинәт	ADV
капчыкла	V
индивидуаль	ADJ
теизм	N
металлолом	N
кичләт	V
тәбәнәклә	V
архаик	ADJ
национализация	N
квалификациялә	V
дау	N
сөзәклә	V
гел	ADVV_NEG
машиналаштыр	V
рамла	V
йомшарт	V
Шнә	N
таралгы	N
теплотехник	N
комташ	N
девиз	N
уылдык	N
кимчелек	N
гектар	N
гөман	N
землячество	N
суверенитет	N
кандидатура	N
юнь	N
яшма	N
тунгус-маньчжур	ADJ
үләксә	N
тәрбиялә	V
мактаныч	N
Шм	N
санкциялә	V
портмоне	N
тамыр-томыр	N
индивидуализм	N
тавис	N
кыйтга	N
кушылма	N
боргычла	V
рупия	N
утлат	V
шлем	N
Шм	V
нафталинла	V
бармак	N
чапырда	V
белдермә	N
кичәгенәк	ADV
виолончель	N
ирония	N
якынай	V
калык	PN
финансла	V
шәхес	N
тәпичә	N
экзотик	ADJ
әрәмә	N
баллан	V
бокал	N
литерла	V
маһир	ADJ
зачет	N
мираж	N
лимонад	N
бөркүлән	V
ритмика	N
целлюлоза	N
рахит	N
мәҗлестәш	N
резинка	N
аргентиналы	N
партнер	N
Шнтек	V
нивелировка	N
былтыргы	ADJ
биофильтр	N
карла	V
тыпырдат	V
синтетика	N
туксанла	V
структур	ADJ
испәрәк	N
ачысы-төчесе	N
пакьлә	V
этногенез	N
карылда	V
ялга	V
мотороллер	N
алпамша	N
төлке	N
мушкет	N
аффикс	N
табагач	N
төбәл	V
айкан	V
манчестер	N
тешләт	V
паранойя	N
очкылык	N
чукырда	V
капонир	N
абстракт	ADJ
тап	V
шәмаил	N
бакалея	N
тап	N
кысыр	ADJ
русла	V
нефтехимия	N
антипатия	N
сыз	V
мутацион	ADJ
гравитацион	ADJ
унике	NUM
нацист	N
примус	N
өнә	V
Шскер	V
төрекмән	N
коридор	N
ялгавыч	N
бүдәнә	N
такырла	V
яньче	V
ихатала	V
сиртмә	N
чехол	N
аспект	N
иртәгә	ADV
тыкшын	V
тәгәрә	V
секвойя	N
турыла	V
арзанай	V
ашханә	N
социологик	ADJ
тәрҗемә	N
адарын	V
кабатлан	V
кылый	ADJ
бертын	ADVV_NEG
схоластика	N
фрейдизм	N
консул	N
йөрәклән	V
уяткыч	N
замандаш	N
корпус	N
эфедрин	N
глобус	N
ырудаш	N
пермь	N
игелек	N
бериш	N
мавзолей	N
Шкенчесе	ADJ
брадәр	N
астрология	N
полигон	N
гуманизм	N
нәзбереклән	V
эйфория	N
штабель	N
вика	N
йөгерен	V
ландыш	N
химик	ADJ
борындык	N
терлек-мал	N
иртән-иртүк	ADV
каралҗым	ADJ
эталон	N
кайтым	ADJ
инспектор	N
дарула	V
койтылан	V
учмала	V
леспромхоз	N
жезл	N
бөкелә	V
порхылда	V
кузгал	V
шифаханә	N
юаткыч	N
җимерт	V
кысрыклык	N
бак	N
генплан	N
хирургия	N
социаль	ADJ
биографик	ADJ
кисәк-косак	N
баллада	N
кыскарт	V
социал-демократия	N
ябышкак	ADJ
төрки-татар	N
сач	N
иярлән	V
комарлан	V
бензин	N
опера	N
шалфей	N
лай	N
чатлама	ADJ
логистика	N
табылдык	N
консолидация	N
кәгазь	N
түшә	V
сукран	V
солярка	N
конгресс	N
түзгесез	ADJ
эш-йомыш	N
актарын	V
бозлан	V
тараф	N
ярминкә	N
перкуссия	N
күкрәт	V
кисекбаш	N
статист	N
нәфис	ADJ
саванна	N
шушы	PN
төрен	V
юань	N
Шнтеграл	N
тозлавык	N
өргеч	N
кочегар	N
мәсхәрә	N
допинг	N
мәкам	N
шәрык	N
нәфрәт	N
тавыш-өн	N
чәйдәш	N
шатырдат	V
бронхит	N
кузна	N
бәялә	V
ябала	V
либретто	N
сөмбаш	N
бирел	V
гыйззәт	N
хаҗи	N
ятышлы	ADJ
алкоголик	N
гидрогенератор	N
барыбер	ADV
яралан	V
сөяк-санак	N
баллистик	ADJ
желатин	N
күргәз	V
аңардан	PN
мумия	N
зирәклән	V
фраза	N
дифтонг	N
йөгәнсезлән	V
сөзәк	ADJ
китмән	N
болганчык	ADJ
юк	PN
кырку	ADJ
гөжлә	V
мәнфәгать	N
аллигатор	N
ашал	V
копия	N
материал	N
синтагматик	ADJ
каска	N
үзбәк	N
лакан	N
камала	V
экспрессионизм	N
гудок	N
негатив	N
банкрот	N
транспорт	N
атчабар	N
таяныч	N
бүрек	N
фототелеграмма	N
кыскартма	N
кабак	N
күзәнәк	N
кавказ	N
сыздыр	V
төз	V
металлик	ADJ
шыгырдат	V
бап	N
медицина	N
камчыла	V
балта	N
тойгы	N
аю	N
шылан	N
күкчәчәк	N
гаруз	N
соргылт-зәңгәр	ADJ
менла	N
бурса	N
лобелия	N
интервал	N
рептилия	N
үлем-җитем	N
шлея	N
инкубация	N
когорта	N
кедр	N
таңкучат	N
метаморфоз	ADJ
җил	N
колачла	V
кыйммәтсен	V
җил	V
водевиль	N
кушаякла	V
урман-дала	N
мыжгыт	V
пантеизм	N
күпсанлы	ADJ
нит	V
пальма	N
гинекология	N
шәүлә	N
нәрәтә	N
конструкция	N
кумулятив	ADJ
исәбе-саны	N
җигем	N
чалмалы	ADJ
тыч	V
нишан	N
тема	N
латинла	V
ифадә	N
муафыйк	ADJ
сиземлә	V
литера	N
ташландык	ADJ
мәтле	ADJ
латин	ADJ
шыр	ADV
бөгелмә	N
күклә	V
үрчем	N
комган	N
сең	V
кызу	ADJ
такмаза	N
гриф	N
энергия	N
карын	N
алимент	N
күптәннән	ADV
кет	N
расист	N
патруль	N
телен	V
үтел	V
кашбау	N
урлан	V
сиздер	V
туз	N
наркоз	N
күпертмә	N
иртәсе	ADV
туз	V
варис	N
ре	N
юри	ADVV_NEG
утар	N
сүзлекчә	N
фантаст	N
убу	N
кабартма	N
колонист	N
җый	V
компрессион	ADJ
җәзалан	V
сәлам	N
мәшәкатьлән	V
борынла	V
кюри	N
готик	ADJ
чабыл	V
белдер	V
подшипник	N
күзәтел	V
таксофон	N
сүзмә-сүз	ADVV_NEG
капитуляция	N
магнитла	V
әверел	V
күкшеллән	V
эполет	N
кызтәкә	N
эскерт	N
зыяфәт	N
төзәт	V
фотоаппарат	N
башаклан	V
моңсу	ADJ
савыт-саба	N
конспиратив	ADJ
резервация	N
барбарис	N
фин	N
ак	V
күңелсезлә	V
йотым	N
тикшерт	V
бикәч	N
чекерәй	V
респиратор	N
налог	N
маузер	N
плутоний	N
шаккаткыч	ADJ
кисәт	V
экскаватор	N
тансык	ADJ
хыянәтчел	ADJ
сүсән	N
примитивла	V
борча	N
лайлалан	V
патша	N
психопат	N
курк	PN
тюркологик	ADJ
транскрипциялә	V
колоратура	N
мутаген	ADJ
алдыр	V
итлә	V
ярал	V
ризык	N
платина	N
рефлекс	N
люпин	N
ирле	ADJ
балет	N
йөгәнләт	V
саклат	V
фани	ADJ
лимит	N
бүгенле-иртәгәле	ADV
ланцет	N
юллан	V
овал	N
компетенция	N
тШң	ADJ
пачка	N
боцман	N
эшелон	N
ват	V
йолдызнамә	N
маньчжур	N
регистрациялә	V
аерата	ADVV_NEG
минимум	N
юрамалый	ADV
җиһангир	N
капкорсак	N
календарь	N
меломан	N
велюр	N
гусар	N
тә	V
комплимент	N
сенегал	N
тә	N
некролог	N
бенгаль	ADJ
тотыл	V
план	N
диабет	N
элгәш	V
ямьшәй	V
җеп	N
гаип	N
үчеклә	V
сагыш	N
кыркучы	N
парик	N
кинофильм	N
бүс	V
төсмерлә	V
хезмәтчел	ADJ
боҗрала	V
мәңге	ADVV_NEG
самими	ADJ
поселок	N
чуман	N
кушсузыклар	N
чекелдә	V
мәрт	N
гареп	N
вельможа	N
уңагай	N
цилиндр	N
көрәк	N
кырынайт	V
йомрылан	V
каймала	V
брюнет	N
бухгалтерия	N
райсовет	N
кузгаткыч	N
пинцет	N
диалектология	N
кыштырдат	V
казы	N
экспертиза	N
хромосома	N
чаллан	V
поручик	N
казы	V
сүс	N
һәндәсә	N
королева	N
миски	N
сыргалан	V
боламык	N
челәйт	V
сихри	ADJ
сыткыла	V
хронометражист	N
тапкырчыгыш	N
циклон	N
притон	N
хлорка	N
имән	V
тамакла	V
саңгыраула	V
бригантина	N
мәрхүмә	N
алсу-зәңгәр	ADJ
монархия	N
имән	N
бортрадист	N
туңбаш	N
Шшет	V
кушкуллап	ADVV_NEG
фрейлейн	N
шакшыла	V
гастроном	N
эчер	V
паспортистка	N
Шспан	N
озайт	V
калдау	ADJ
дәүләт	N
утырдаш	N
мәгыйшәт	N
сызгырын	V
карикатурала	V
канна	N
реверанс	N
шифа	N
киловатт	N
тимер-бетон	N
бөтенхалык	ADJ
калмык	N
Шләслән	V
рефери	N
Шсбатла	V
чажла	V
саксофон	N
сонет	N
профсоюз	N
тафта	N
теория	N
бистә	N
гипертония	N
стадий	N
листок	N
аңкау	N
боксит	N
сыекла	V
эмиграция	N
бакый	N
тышлат	V
дүртпочмак	N
катастрофа	N
Шр-хатын	N
славянла	V
климатик	ADJ
өнәмә	V
судно	N
адвокат	N
чәл	V
политмәгариф	N
гроссмейстер	N
болонья	N
производство	N
тешәт	V
әкәлә	N
магаданлы	N
кибитка	N
кунак	N
алама	N
шатрун	N
күгелҗем	ADJ
комсызлан	V
телеграфистка	N
дулкынландыр	V
алфавит	N
старт	N
ногыт	N
демонтажла	V
палеоазиат	ADJ
карабодай	N
каптерка	N
нәсех	N
гариплән	V
төнә	V
яманла	V
элмәк	N
ым	N
бүлек	N
кот	N
тюкла	V
оядаш	ADJ
Шмператор	N
чын	ADJ
медаль	N
манипуляциялә	V
уймыр	N
генезис	N
фиксациялән	V
шунча	PN
кара	ADJ
стабильлә	V
дагала	V
перрон	N
буш	ADJ
ыһылда	V
демография	N
тарелка	N
ши	ADJ
алсулан	V
балавызла	V
олпат	ADJ
гырылда	V
йөзек	N
гарасат	N
шлюзла	V
локаль	ADJ
быкырда	V
Шгенче	N
ифтира	N
партия	N
суын	V
суперйолдыз	N
җәнҗалла	V
биатай	N
йодрыклан	V
заклад	N
мадьяр	N
кетердәт	V
җепше	V
Шр-ат	N
белдекле	ADJ
бәбәк	N
обер-прокурор	N
такылдавык	N
блок	N
вена	N
зәхмәт	N
речитатив	N
трасса	N
махорка	N
комбинезон	N
ырымла	V
каравыл	N
шаукым	N
фактория	N
ышык	N
эсминец	N
дәү	ADJ
келә	N
гектограф	N
сүсәр	V
профилактик	ADJ
аеры	ADVV_NEG
үр	N
зонд	N
ирдәүкә	N
резус-фактор	N
күлчә	N
керлән	V
иярт	V
оратор	N
сезон	N
энтузиазм	N
вагонетка	N
тузан-туфрак	N
үр	V
мелодия	N
кретин	N
кабызгыч	N
пудель	N
русизм	N
эчкече	N
флажок	N
плебисцит	N
хосусән	ADV
кабатлат	V
чачакла	V
кокаинизм	N
эссе	N
алиби	N
альбом	N
әспе	N
серкәлән	V
батырайт	V
өчаяк	N
уен	N
тондыргыч	N
тактыр	V
авангардист	N
чечетка	N
максат	N
сазау	ADJ
каймак	N
монумент	N
мунча	N
боксер	N
әтрәк-әләм	N
Шңгән	ADJ
шул	PN
лапы	N
космогония	N
экстерриториаль	ADJ
шомпол	N
канифольлә	V
гестапо	N
цементлан	V
дислокация	N
сбруй	N
мнемоника	N
баягы	ADJ
проектла	V
минога	N
дилижанс	N
югалт	V
акрехин	N
әргән	N
шартлат	V
тынычландыргыч	ADJ
шәхси	ADJ
лей	N
мәче	N
илгәсәр	N
фразеологик	ADJ
очанак	ADJ
омнибус	N
стильләштер	V
партҗыелыш	N
лаборатория	N
Шсәплә	V
чирак	ADJ
оператив	ADJ
мөнәсәбәт	N
каптырма	N
кычу	N
горгылда	V
гра	N
ливияле	N
шарла	V
югарыгы	ADJ
күгелҗемлән	V
ларингит	N
вариант	N
яула	V
сыктан	V
ассоциация	N
кармак	N
электротехник	ADJ
паз	N
кояш	N
акустика	N
җиленлә	V
шаһ	N
төрлелән	V
асра	V
иҗади	ADJ
мен	V
җиң	V
күптавышлы	ADJ
тәмамлат	V
камергер	N
күркәмлә	V
җиң	N
җилемлә	V
төзеклән	V
назым	N
цикорий	N
миокард	N
инәл	V
понтон	N
пошкырын	V
пенсне	N
нәзек-озын	ADJ
нишләт	V
Шрәй	V
композитор	N
хөкүмәт	N
юанай	V
даими	ADJ
философ	N
зиндан	N
буйсын	V
текстология	N
йолкы	V
чабагачла	V
забастовка	N
пассивла	V
бичура	N
сатира	N
идеаль	ADJ
дымык	V
кургаш	N
марал	N
экзема	N
ошат	V
шакшы	ADJ
акчарлак	N
әти	N
градусник	N
эзләгеч	N
каушат	V
фиксациялә	V
шакылда	V
чек	N
чирләт	V
микробиолог	N
колея	N
интерпретациялә	V
такылда	V
начарлан	V
баклажан	N
карчык	N
рәвешлә	V
дөнья	N
фактик	ADJ
озон	N
томаула	V
унбер	NUM
дөрселдә	V
симптом	N
койгыч	N
гарнир	N
социологизм	N
учма	N
түлә	V
штукатурлан	V
эпизод	N
кычкырт	V
бәйнәлмиләл	ADJ
хәйлә	N
монгол	N
профессия	N
тирлә	V
дворян	N
приклад	N
Шнгуш	N
суфичыл	ADJ
обой	N
ышандыргыч	ADJ
конфискация	N
акыртын	ADV
садака	N
рәссам	N
җисем	N
янык	N
башкүкрәк	N
саф	ADJ
позиция	N
атла	V
ала	ADJ
кәккүк	N
карар	N
хөр	ADJ
арендала	V
гуттаперча	N
әсир	N
тәмлекәй	N
югары	ADJ
җилгә	V
ыржайт	V
отличник	N
зарур	ADJ
каравай	N
микробиологик	ADJ
ихтираг	N
үлчән	V
пешек	V
каңгылдык	ADJ
янкапка	N
сумка	N
сабынла	V
шахтер	N
шылтыравык	N
компаниячел	ADJ
әмәл	N
микроскопик	ADJ
нервлан	V
тракт	N
мускат	N
тискәре	ADJ
Шген-тару	N
гибрид	N
ватыл	V
нонпарель	N
диярлек	ADVV_NEG
җәйлә	V
кенәри	N
дзюдо	N
ек	V
кырык	V
үтерт	V
коррозия	N
прерия	N
шапшак	ADJ
күн	V
лар	N
ялтыра	V
биклән	V
әүвәле-ахыры	N
күн	N
котчыккыч	ADJ
космонавтика	N
шопырдат	V
горизонталь	ADJ
хайвани	ADJ
чуарлат	V
тоташ	V
штиль	N
фонендоскоп	N
җирән	ADJ
казеин	N
феодализм	N
филологик	ADJ
бәя	N
рия	N
бүлмә	N
юлык	V
ислам	N
этимологик	ADJ
силлабик	ADJ
плинтус	N
нитрагин	N
кызкай	N
берданка	N
үчек	V
хәттат	N
мемуар	N
тәвәккәл	ADJ
перфоратор	N
украинла	V
крахмаллан	V
аксак-туксак	ADJ
механизм	N
уены-чыны	N
эпифора	N
ссуда	N
аты-чабы	N
телемлә	V
холестерин	N
явым	N
соңра	ADV
разый	ADJ
тышкы	ADJ
радиотехника	N
бәвел	N
кадровик	N
тубык	N
басу	N
санат	V
педиатр	N
гарип	N
аренда	N
үтерел	V
телбизәк	N
көй	N
траектория	N
наркологик	ADJ
күзлек	N
көй	V
антивирус	N
уят	V
гашетка	N
авиамәктәп	N
йөрт	V
махсус	ADJ
апорт	N
тумачи	N
Ш	V
агентура	N
апельсин	N
реабилитация	N
келәт	N
мортира	N
Шртәгә	ADV
затвор	N
чистар	V
рәшәткә	N
Ш	N
Шнтерпол	N
кирт	N
бакырда	V
лаклан	V
күзкәй	N
ширма	N
компетентлык	N
һай-һула	V
сый	V
антрекот	N
каприччио	N
тиңсен	V
сый	N
радиомонтаж	N
тенденция	N
җилкуар	ADJ
грамматик	ADJ
асылташ	N
әртиллә	V
үрген	N
парла	V
фтор	N
атал	V
концессия	N
мәҗмуга	N
бат	V
төгән	V
аз-маз	ADVV_NEG
төнбоек	N
гасаби	ADJ
урман	N
мүклә	V
фокус	N
обсерватория	N
кай	PN
тигезлән	V
әлифба	N
дуслан	V
күкрәвек	N
бербер	N
юрист	N
дот	N
сыеклат	V
бәдбәхет	N
азот	N
манипуляция	N
тизләт	V
вокаль-симфоник	ADJ
кинематографик	ADJ
теологик	ADJ
иренчәк	ADJ
кушымта	N
газиз	ADJ
боерык	N
аңгар	V
унификация	N
синтаксист	N
тарШх	N
бөке	N
үгет	N
болан	N
бинт	N
боеклан	V
иҗеклә	V
героиня	N
вәгазь-нәсихәт	N
тиргәл	V
совнарком	N
күркә	N
том	N
үзагышлы	ADJ
җеназа	N
йөзмә	ADJ
катар	N
твист	N
капыл	ADV
нумизматик	ADJ
этнонимика	N
отряд	N
тәмлетамак	N
нард	N
өтәлә	V
аран	N
шылтыра	V
рун	N
Шңрә	V
сценарий	N
виктория	N
тампон	N
бизәклән	V
перпендикуляр	N
көньяшәр	N
вираж	N
дүдәк	N
федераль	ADJ
дискуссион	ADJ
лицензиялә	V
стратег	N
коткар	V
йөреш-килбәт	N
экстра	ADJ
ялганла	V
шеренга	N
зыян-зарар	N
бушат	V
атын	V
инәкә	N
иңсәлә	V
кыс	V
начарайт	V
тәрәт	N
кыстал	V
экстрен	ADJ
ләп	ADV
көндезге	ADJ
вербовка	N
жәлләт	V
талак	N
химия	N
узел	N
бюрократ	N
швейцар	N
саржа	N
печенье	N
якты	N
герб	N
деспот	N
кылыйлат	V
капылда	V
морфий	N
мисал	N
күзсен	V
Шлбасар	N
пәйгамбәр	N
ләйсән	N
тиң	ADJ
көнҗәлә	N
өшет	V
чемодан	N
дар	N
и	V
әйбер-фәлән	N
телдәрлән	V
бүлтәй	V
компилятив	ADJ
аксакла	V
кварк	N
трактор	N
десятник	N
сенсацион	ADJ
һәрьяк	N
миңгерәт	V
флот	N
кастор	N
бөр	V
вермут	N
энтомологик	ADJ
җилен	N
межала	V
врач	N
әҗер	N
ызгыш-бәхәс	N
тырнак	N
магистрант	N
якалы	ADJ
экзамен	N
Шпекәй	N
стратегик	ADJ
әүмәлә	V
вөҗдани	ADJ
колач	N
янәдән	ADV
кызамык	N
делегат	N
гөлдерә	V
гәүр	N
яткан	ADJ
ис	V
пәрмә-пәр	ADVV_NEG
кыярчалар	N
ленч	N
рәхим	N
электрик	ADJ
ахмаклан	V
электрификация	N
аттыр	V
торна	N
аромат	N
әрнеткеч	ADJ
стопор	N
ис	N
трос	N
йомры	N
тритон	N
автобаза	N
өчләт	V
карпыч	N
фикер	N
кока	N
терә	V
тупылдат	V
көпе	N
Шмгәк	N
алтай	N
алар	PN
орлык	N
готтентот	N
тиреслә	V
төгәлләмә	N
баһадир	N
исәнгерә	V
памфлет	N
балык	N
Шкра	N
практикум	N
бичаракай	N
арифметика	N
үсенте	N
бөтен	PN
күгәрт	V
берчак	ADVV_NEG
ялтырбаш	N
чос	ADJ
фырылдат	V
угызлан	V
пи	N
алхимик	N
өслә	V
марксист	N
колонка	N
азалия	N
берәмләп	ADV
шагыйранә	ADVV_NEG
конфетти	N
дирһәм	N
җилсен	V
мужик	N
нумизматика	N
шакшылык	N
шыбырда	V
килбәтсезлән	V
өметлән	V
башлан	V
ленин	N
тәләкә	N
пенс	N
стражник	N
авыз	N
токсиколог	N
чабак	N
сәмих	N
тәбәнәк	ADJ
антропология	N
полуторка	N
аңынчы	ADV
ары-бире	ADV
гөллә	V
шапырт	V
фальшборт	N
тузгыт	V
күкле-кызыллы	ADJ
көндәш	N
офык	N
тальк	N
энергетик	N
саламторхан	N
казылык	N
франк	N
затсызлан	V
валидол	N
кугын	N
акварель	N
тар	ADJ
шовинист	N
цинклан	V
Шп	N
эскимо	N
сольфеджио	N
имәнеч	ADJ
махмырла	V
экология	N
кечелән	V
кетердәвек	ADJ
чокырлан	V
җәдвәл	N
фасоль	N
соң	ADV
империализм	N
тетралогия	N
монографик	ADJ
пирога	N
симер	V
швейцарияле	N
давыл	N
үлемдар	N
нөктә	N
райисполком	N
пароним	N
фитонцид	N
фәләк	N
мастерской	N
кәрвансарай	N
намус	N
аферист	N
ар	N
магнит	N
дилетант	N
экзекуция	N
туң	N
кырыслан	V
бөтенәйт	V
шаккатыргыч	ADJ
туң	V
көлдергеч	ADJ
гипсла	V
ар	V
имла	N
химиотерапия	N
импрессионизм	N
юлбасар	N
пешка	N
методик	ADJ
чиге-чамасы	N
яшүсмер	N
чарылда	V
баллон	N
прәшкә	N
хорунжий	N
ми	N
учла	V
купорос	N
бастыр	V
люминал	N
вьетнам	N
кыйсмәт	N
чал	ADJ
партбилет	N
шпиндель	N
түн	N
күсә	ADJ
демократ	N
симфоник	ADJ
әҗәл	N
көпчәк	N
минималь	ADJ
иснәт	V
малахит	N
карышла	V
асфальтлан	V
пугач	N
тарайт	V
керәч	N
тәгаенлә	V
тарантас	N
ряса	N
кастелянша	N
күпчек	N
кара-кучкыл	ADJ
моңсулан	V
диалекталь	ADJ
иләмән	N
бурка	N
магнитлан	V
барыш	N
селкенчәк	ADJ
түләм	N
урталай	ADVV_NEG
кабатланма	N
альбатрос	N
деградация	N
томшык	N
әңгәмәләш	V
лютеран	N
пудра	N
лазер	N
каргаборын	N
көлсу	ADJ
көрси	N
ксендз	N
аерма	N
энекә	N
норсульфазол	N
фөрьяд	N
кәнтәй	N
сөртен	V
әштер-өштер	ADV
турсайт	V
эшләпә	N
кәрешкә	N
префиксаль	ADJ
кредо	N
зарар	N
бил	N
индикатор	N
азчылык	ADJ
волюнтаризм	N
кабельтов	N
разряд	N
Шхата	N
таран	V
кыегайт	V
отлично	N
төзән	V
ышаныч	N
таран	N
бикфорд	N
көчән	V
иттифакый	ADJ
индустриялә	V
дюраль	N
шпон	N
вуаль	N
резервуар	N
ишеттер	V
үлеклә	V
чик	N
сургуч	N
опты	N
истирахәт	ADJ
пластилин	N
нафтизин	N
Шлаһем	N
гафил	ADJ
төбә	V
мәмилән	V
шулпалан	V
граната	N
гөрселдә	V
рефлексия	N
повар	N
күрше-тирә	N
билчән	N
гөләп	N
фацет	N
огнемет	N
ыржай	V
могтәбәр	ADJ
топаз	N
баланда	N
мегаполис	N
кизил	N
мөхаль	ADJ
бәлки	CNJ
эне	N
студия	N
күлем	N
тотнак	N
әсәр	N
афган	N
ныгыт	V
дека	N
әсәр	V
тиун	N
җиткез	V
маршла	V
яктырткыч	N
кичке	ADJ
тавтология	N
балластла	V
лоцман	N
мисс	N
пижама	N
вандал	N
исрафчыл	ADJ
такырлан	V
луноход	N
физиология	N
веранда	N
тиосульфат	N
наказ	N
взвод	N
сары	ADJ
купай	V
төнәтмә	N
идиотизм	N
хисапла	V
камерун	N
украинлы	ADJ
саплан	V
күрәгә	N
диффузор	N
өчәрлә	V
мотив	N
гран-при	N
сейсмограф	N
көмешлә	V
контур	N
бөгәлчән	N
куел	V
прибор	N
барс	N
аңдыр	V
тәмлә	V
азау	ADJ
напалм	N
сыйныф	N
күзелдерек	N
прогресс	N
юмартлан	V
гидрогеолог	N
сансызлан	V
хамса	N
чабата	N
кыҗрат	V
палеонтология	N
качыр	V
пират	N
салам	N
азай	V
Шшлә	V
киртә-кура	N
акула	N
шәфә	N
сырхау	ADJ
энциклопедия	N
аллан	V
буп-буш	ADJ
эрудиция	N
мөгаллимә	N
туралы	N
текстологик	ADJ
эмиссия	N
груша	N
каплат	V
наный	N
кабинет	N
көнчел	ADJ
ладья	N
турнепс	N
мөхтәрәм	ADJ
партиядәш	N
дискуссия	N
тукландыр	V
цифр	N
анахронизм	N
скумбрия	N
лавина	N
түңел	V
тәфсШр	N
суфила	V
орбита	N
бухгалтер	N
обструкция	N
түбәлән	V
пунктуация	N
бертөрле	ADJ
нарасый	N
гарнитур	N
авангардизм	N
муштра	N
сайлаучы	N
мигрень	N
исемдәш	N
титр	N
мантыйкый	ADJ
хәйләкәрлән	V
Шкенчеләй	ADV
гидрологик	ADJ
почерк	N
зигзаг	N
иптәш	N
җәнап	N
шифер	N
бермә-бер	ADV
Шшеткән-белгән	ADJ
монголоид	ADJ
лабаз	N
харита	N
комиссар	N
аккумулятор	N
канцелярист	N
реликвия	N
макулатура	N
ясмин	N
хром	N
сау	V
кинетик	ADJ
кырындыр	V
йолдызак	N
коры-сары	N
бер	NUM
мутон	ADJ
җаһиллән	V
плантатор	N
совхозла	V
тет	V
балка	N
он	N
тәртиплән	V
сага	N
сөйдергеч	N
чыңгырда	V
кисәүлән	V
иркен	ADJ
сыдырыл	V
авантюристик	ADJ
фаталь	ADJ
прокладка	N
өч	NUM
чистарт	V
автозавод	N
статс-секретарь	N
кысмыр	ADJ
мускулатура	N
кыркулан	V
шахта	N
октябрь	N
юртак	N
сихерлә	V
брамат	N
удмурт	N
хәтәр	ADJ
паяльник	N
пропагандала	V
яше-карты	N
гөл	N
мөхлис	ADJ
донкихотлык	N
ялкын	N
сырга	N
чытырман	N
трансформациялә	V
мөбарәк	ADJ
каштан	N
ханзадә	N
йөкләт	V
буталан	V
бозау	N
вершок	N
хәшәп	N
радиохимия	N
альянс	N
металлургия	N
тара	V
интермедия	N
хокукый	ADJ
дизайн	N
урбанистик	ADJ
киңәщел	ADJ
ияләш	V
олимпиада	N
сапламла	V
янәшәлек	N
корылма	N
көчәйткеч	ADJ
хорват	N
раслан	V
тикшер	V
төтен	N
бәрел	V
өрек	V
визир	N
төсле	ADJ
минала	V
мулла	N
Шң	V
гөлбакча	N
акциз	N
җШр	N
гәп-әңгәмә	N
букча	N
өмит	N
кий	N
капка	N
аять	N
аз-азлап	ADVV_NEG
соя	N
маҗар	N
чырак	N
пломба	N
иркәк	N
йорт-җир	N
таны	V
чере	V
конституцион	ADJ
орчыкбаш	N
кытырдат	V
олыгай	V
шШрбәт	N
кыска	ADJ
искиткеч	ADV
юхалан	V
ярус	N
эрекция	N
теләт	V
шыгырда	V
мунчак	N
манто	N
җилкенчәк	N
гөжләт	V
шешен	V
омтыл	V
кыеклат	V
алҗыт	V
бүген	PN
журналистика	N
каһәрлә	V
агитация	N
салмаклат	V
шакырай	V
хатыншалан	V
мисле	ADJ
юынгыч	N
чагыштыр	V
шадрала	V
юкагач	N
провинциаль	ADJ
профилактика	N
график	N
андыз	N
антипедагогик	ADJ
совнархоз	N
магнетизм	N
күркәм	ADJ
селәүсен	N
тәбәнәгәй	V
анысын-монысын	PN
затланышлы	ADJ
тулылан	V
промысел	N
кигерт	V
сузан	ADJ
археограф	N
боргала	V
нәсыйхәтлә	V
эскәнҗә	N
сизерә	V
эрләт	V
педагогик	ADJ
чукынмыш	N
эксплуатация	N
функциональ	ADJ
пост	N
профессионал	N
сызлат	V
чира	V
киптер	V
путал	N
алыштыргысыз	ADJ
тәүге	ADJ
спора	N
әүвәлдән	ADVV_NEG
аша	V
йонлы	ADJ
үзсен	V
оештырыл	V
бал	N
палеография	N
җизлә	V
гөлбостан	N
шлак	N
кыпчак-болгар	N
архаизм	N
нитрокушылма	N
бердәй	ADJ
кызулан	V
тизәклә	V
чапырдат	V
ном	N
операцион	ADJ
керпелән	V
үзирекле	ADJ
тигер	V
самолет	N
ярсу	ADJ
кансу	ADJ
балчык	N
кролик	N
кантар	N
тамчы	N
паралич	N
проба	N
перспектив	ADJ
оша	V
чикләвек	N
бәләкәйлән	V
чыжым	N
кремациялә	V
маринадла	V
эчкерле	ADJ
сеңелкәй	N
очра	V
стиль	N
кырлы-мырлы	ADJ
төтәгеч	N
миһаһай	V
оныттыр	V
киртләч	ADJ
акушер	N
уртаклык	N
бөкрәй	V
принц	N
саташ	V
диктофон	N
мәрмәр	N
габарит	N
кан-сүл	N
морфин	N
дөреслән	V
җирлә	V
угыл	N
ярсыткыч	N
сүген	V
станция	N
Шске	ADJ
рөхсәтнамә	N
сүлпәнәй	V
кылган	N
сүрәнлән	V
яшел	ADJ
бөртеклә	V
прогноз	N
азаккы	ADJ
ыслат	V
тул	V
ялык	V
әтраф	N
гарәпчә	ADJ
хәсис	ADJ
ука-чук	N
гравер	N
күңеллән	V
башка	ADJ
фора	N
шантажла	V
эшер	V
дифтерит	N
аргон	N
кунакчыл	ADJ
карлык	V
проспект	N
хайванлан	V
моряк	N
йончу	ADJ
җайсызлан	V
формализм	N
пунктир	N
каторжник	N
умырзая	N
әби	N
апара	N
кетердә	V
киномеханик	N
күпсен	V
чырыйла	V
полиграфист	N
индикатив	ADJ
оазис	N
висмут	N
бөгәрлә	V
бригада	N
квартира	N
альпинизм	N
көрән	ADJ
тимрәү	N
сарафан	N
йокылы-уяулы	ADJ
үч	N
мутагенез	N
көллә	V
сынла	V
шәмәхәлән	V
пристав	N
китапханә	N
штампла	V
пычран	V
бүре	N
бельгияле	N
әйләнә	N
дә	ADJ
маемсыра	V
тыркылда	V
участок	N
чүпләмә	N
ленинчыл	ADJ
Шслемай	N
хина	N
революциячел	ADJ
пробка	N
кулавыз	N
кундыр	V
бүләк-санак	N
идеалист	N
ысул	N
метионин	N
затланышсыз	ADJ
маргарин	N
сару	N
палатка	N
шпорла	V
костюм	N
официаль	ADJ
кызган	V
умач	N
кадастр	N
дублет	N
аритмия	N
мөгезчел	ADJ
тишкеч	N
сагышла	V
рәШс	N
тай-тулак	N
яшәр	V
полиграфия	N
диссертация	N
киста	N
вариация	N
геометрик	ADJ
формалистик	ADJ
картограф	N
арестант	N
парә	N
цитрус	N
питон	N
һәм	CNJ
тәнкыйтьлән	V
корсак	N
дөңгердәт	V
зәгыйфьлә	V
пирс	N
Шкенде	N
миллиард	NUM
кушык	ADJ
чүкечлә	V
дирижер	N
суганбаш	N
депутат	N
финка	N
ялан	V
ороч	N
эволюцион	ADJ
юлыктыр	V
ялан	N
тәнәфес	N
төпчен	V
дзот	N
синьора	N
балалат	V
кран	N
шөлди	N
бәйлә	V
чумара	N
ләүкә	N
инструкция	N
ләгән	N
коралсызландыр	V
призер	N
аптыра	V
аккош	N
юллама	N
төркемчәлә	V
хезмәткәр	N
шагыйрь	N
җирәнгеч	ADJ
тубал	N
баритон	N
овчарка	N
чиш	V
төртке	N
терракота	N
отпуск	N
һаман	ADVV_NEG
төче	V
шлейф	N
оппортунистик	ADJ
кана	V
интерьер	N
тынгысызлан	V
төче	N
начар	ADJ
курчак	N
лейкемия	N
башкарма	ADJ
абсцесс	N
реванш	N
әни	N
китсыман	ADJ
берара	ADV
радио	N
купайт	V
фильтрация	N
кандаш	N
патрон	N
мишәр	N
реакцион	ADJ
челтәрлә	V
эфШр	N
сөзгәк	ADJ
меланхолия	N
яллан	V
шприц	N
кәрлә	N
чаткы	N
калайла	V
вөҗдан	N
ташлан	V
тәтәй	N
протез	N
шиньон	N
җимшән	N
бикләвеч	N
зим	N
сөяллән	V
каракай	N
пессимизм	N
кыбырда	V
тыл	N
тотрыклан	V
бронемашина	N
фәнни	ADJ
логопедия	N
гыжылдавык	N
земский	ADJ
эшермә	N
әдәбият	N
кашаяк	N
метеорит	N
рухани	N
балла	V
шовинистик	ADJ
пилюля	N
капитан	N
гөрләт	V
буе-сыны	N
ксероформ	N
төр	N
тәре	N
акцент	N
аңсызлык	N
гильотинала	V
санкция	N
эрелән	V
агитатор	N
җанландыргыч	N
үңәч	N
яңгыр	N
ультрамарин	N
асма	ADJ
төр	V
кызылҗимеш	N
Шгәү	N
бергәлек	N
ул-кыз	N
тиз	ADJ
ябыштырт	V
коргаксы	V
килделе-киттеле	ADJ
бурыч	N
икәүләшеп	ADVV_NEG
гөмбәчек	N
сервиз	N
бюрократик	ADJ
кыя	N
сардина	N
статистик	ADJ
әзерлән	V
оптималь	ADJ
аллерголик	ADJ
энтузиаст	N
синтаксис	N
косынка	N
постимпрессионизм	N
сиземлән	V
торыпша	N
афористик	ADJ
ликвидатор	N
трамвай	N
гәүһәр	N
җайла	V
бөгел	V
кушаваз	N
күчермә	N
флакон	N
арифмометр	N
пантеон	N
хаста	ADJ
сыман	PN
чыгтай	N
бахбай	N
куныч	N
кәрниз	N
шопыр	V
чуп	PREF_ULTRA
джемпер	N
сызлан	V
дисәтник	N
әләм	N
радиолокатор	N
тренаж	N
коткарыл	V
очкын	N
промышленность	N
сибәлә	V
сыйфатлан	V
сыйфатланмыш	N
һаман	ADV
дубляж	N
җил-давыл	N
янчык	N
тыгынлык	N
иренчәклек	N
кирпечлә	V
дәш	V
чүмәләлә	V
азык-төлек	N
аппарат	N
кизләү	N
кристаллизатор	N
милке	N
кис	V
кырмыска	N
советла	V
кирәгә	N
тырыша-тырмаша	ADV
макака	N
гага	N
полифония	N
шалапай	N
архитектура	N
көзгелән	V
нельма	N
авиаконструктор	N
тәшвиш	N
соң	ADVV_NEG
кораб	N
космополит	N
эпилепсия	N
ярты	N
форматив	ADJ
тотемистик	ADJ
ләү	N
яклан	V
манный	N
амбулатория	N
буынла	V
нишләп	PN
дермантин	N
кашлак	ADJ
озак	ADJ
энтомология	N
жилет	N
абунә	N
өре	N
ефрейтор	N
антинейтрино	N
айбалта	N
мопед	N
монография	N
тугайлан	V
бит	N
аркан	N
иртән	ADVV_NEG
расписка	N
психотерапия	N
шалтыра	V
кулсыз-аяксыз	ADJ
автопортрет	N
мөдирә	N
тутык	N
бәбкәлә	V
повидло	N
флотилия	N
эмбрион	N
һәлак	N
зарядка	N
тюлька	N
прессла	V
азсын	V
мебель	N
централизм	N
кредитор	N
шыртла	V
Шртүк	ADVV_NEG
кыстыр	V
кувшин	N
үлем-китем	N
универсиада	N
күптөсле	ADJ
кәвеш	N
кечтек	ADJ
стиляга	N
мамлүк	N
остаз	N
көнбатыш	N
Шрсәк	ADJ
гөрелдәвек	N
диңкет	V
гаугалы	ADJ
анималист	N
охранка	N
тәп	PREF_ULTRA
фураж	N
радиоактив	ADJ
тукмакла	V
камбала	N
чалшайт	V
караҗимеш	N
народник	N
ремонт	N
мөсафирханә	N
сөрем	N
никах	N
карыз	N
пәрәмәч	N
бәбШлә	V
конспиратор	N
имгән	V
кобальт	N
манекен	N
шомакай	N
стереотавыш	N
символик	ADJ
журналист	N
озаклык	N
топографик	ADJ
мә	ADV
гөрләвек	N
кызылтүш	N
сепарация	N
бас	V
дала	N
кыртла	V
авансла	V
Шон	N
рифмала	V
паровоз	N
тузганак	N
хШс	N
комсомолка	N
хунта	N
тычкан	N
тыгыз	ADJ
юморист	N
кардиология	N
бас	N
койка	N
революция	N
интенсив	ADJ
җәбер	N
юрисдикция	N
калория	N
нона	N
кәшфият	N
символлаштыр	V
техминимум	N
диктатура	N
хәлвәфрүш	N
соңар	V
өрпәк	ADJ
кальсон	N
цинк	N
консультант	N
җШл	N
юлдаш	N
демисезон	ADJ
чарлак	N
спекуляция	N
имбир	N
райсоюз	N
бармакча	N
ярымавтомат	N
дистанция	N
денди	N
иссез-тынсыз	ADJ
линолеум	N
һаула	V
карел	N
хиссият	N
бата-калка	ADV
балтыр	N
акваланг	N
казын	V
кузгалыр-кузгалмас	ADJ
печ	V
хитин	N
җәплән	V
такыр	ADJ
үзлә	V
җиләслән	V
бәрдер	V
чибәрлән	V
үтләт	V
кызылканат	N
тундра	N
коелма	N
ромбик	N
галифе	N
әһәмият	N
төшенке	ADJ
бөтенләй	ADVV_NEG
лирика	N
папка	N
экзаменатор	N
чәнечке	N
велосипед	N
хикәят	N
парапсихология	N
мөрит	N
ышыклан	V
тиясе	N
эш	N
хезмәт	N
палата	N
кара	V
ярлы-ябагай	N
диалектолог	N
платформа	N
белен	N
кара	N
лептон	N
чалула	V
район	N
белен	V
радиотехник	ADJ
тарткала	V
гаҗәп	N
чистка	N
башимәс	ADJ
мөгердә	V
кисәклә	V
җыйгыч	N
казаякчалар	N
профилакторий	N
фланель	N
җемелдә	V
мифолог	N
иң	V
чәчәклән	V
иллюстратив	ADJ
укроп	N
викторина	N
обзор	N
хафала	V
мөзакәрә	N
ашамлык	N
антисептик	N
интернационал	N
клоунлан	V
нә	N
Шнтернат	N
ореол	N
сөйрәлчек	ADJ
гимназистка	N
катнаш	V
буй-сын	N
магнитик	ADJ
резерв	N
катнаш	N
сөзмә	N
тәрәч	N
подвал	N
Шнструменталь	ADJ
банда	N
нә	V
җавап	N
аз	ADJ
трагедия	N
мода	N
сабыйлан	V
һәйдә	V
гәүдәле	ADJ
катламла	V
яшь	N
урысла	V
сантехник	ADJ
реорганизация	N
маңгай	N
хикмәти	ADJ
һәрдаим	ADVV_NEG
кылтыра	V
мотивла	V
барометр	N
ак-кара	ADJ
кершән-иннек	N
үпкәләт	V
модерн	N
газават	N
фәлсәфи	ADJ
оек-чабата	N
чына	V
наз-ни	N
дөмектер	V
асфальтла	V
мин	PN
зарар-зыян	N
көпшәлән	V
һушлан	V
тәбә	N
бирге	ADJ
уйсулан	V
җайланма	N
коллекциялә	V
флагшток	N
эчәк-карын	N
афәрин	ADJ
колледж	N
тана	N
плеврит	N
покрау	N
чага	N
вокаль-инструменталь	ADJ
шашлык	N
сазламыклан	V
кыргычла	V
этнологик	ADJ
аристократ	N
моназир	N
азәрбайҗан	N
буят	V
геморрой	N
пүчинкә	N
төйнәт	V
тана	V
спортсмен	N
куныш	N
майлат	V
тире	N
күлдәвек	N
пульт	N
милләт	N
америкалы	N
конвертла	V
эндәш	ADJ
сыгынты	N
төшерел	V
җир	N
цоколь	N
бума	ADJ
углевод	N
кершән	N
акмеизм	N
концертант	N
шат	ADJ
парнас	N
экспрессия	N
хосусият	N
баян	N
покрышка	N
паспорт	N
озынайт	V
козырь	N
электробус	N
им-том	N
күмел	V
нәселдәш	N
пеш	V
олеин	N
үтмәс	ADJ
аяныч	ADJ
күрел	V
комач	ADJ
фикердәш	N
ремонтла	V
манжет	N
бензобак	N
метафаза	N
капитуляциялә	V
коммуналь-торак	ADJ
ихтыяри-мәҗбүри	ADJ
принцип	N
тыйнаклан	V
пош	V
интектер	V
үртә	V
тавык-чебеш	N
баштүбән	ADV
планетарий	N
божан	N
власть	N
бәлеш	N
Шшәй	V
оста	N
реквизит	N
төрле-төрле	ADJ
Шнтеллектуал	N
буржуй	N
дога	N
сәяхәт	N
монтер	N
черет	V
алласыз	ADJ
фетишлаштыр	V
абсолют	ADJ
үлгән	ADJ
адмиралтейство	N
Шс-акыл	N
ябалдашлан	V
тыгызла	V
кыз-хатын	N
морфология	N
сагай	V
киртеклә	V
кәрәз	N
сикертмә	N
күрмеш	N
сотский	N
тузанлан	V
зәңгәрсулан	V
түбәлә	V
күмәкчелек	N
микроавтобус	N
чыелдык	N
аккургаш	N
ябынча	N
терекөмеш	N
монодрама	N
протезла	V
һай-һайла	V
кырма	N
кирказон	N
каршылык	N
макет	N
тоташтыр	V
куентык	N
процессуаль	ADJ
провокацион	ADJ
юандыр	V
кош	N
золым	N
бәлҗә	N
цент	N
терминологик	ADJ
тиамин	N
держава	N
рус	N
җылыткыч	N
метатеза	N
шыт	V
утрау	N
пальто	N
рубрика	N
динар	N
базымчан	ADJ
балтырган	N
тәрәшлә	V
дию	N
лазутчик	N
җилгәрт	V
экономика	N
дафния	N
күргән-белгән	ADJ
баула	V
вице-президент	N
гермафродит	N
нацизм	N
камил	ADJ
омоформа	N
арыгай	V
әлү	N
бер-бер	ADJ
чылтырат	V
будильник	N
юргала	V
профильлә	V
стенд	N
яки	CNJ
гербарий	N
дөмбәслә	V
угалан	V
катафалк	N
ныгы	V
алмашын	V
камиллә	V
гитлерчы	N
кайтма	ADJ
чоңгыл	N
сәнә	N
теплофикация	N
кинозал	N
бозаулат	V
мансарда	N
басым	N
берникадәр	PN
принципиаль	ADJ
сузай	V
корректировка	N
хөрмәт	N
мактат	V
педологик	ADJ
шура	N
пресс-конференция	N
рамка	N
геофизика	N
ялчык	V
перитонит	N
сыланчык	ADJ
тибрәткеч	N
ер	V
рәхмәт	N
культивациялә	V
катлаулылан	V
коймак	N
әфсенлә	V
политехник	ADJ
кыршыл	V
бутама	N
беркаян	ADVV_NEG
әрвах	N
ким-хур	ADJ
пилот	N
салмыш	ADJ
кыбырдат	V
ябылмалы	ADJ
солдат	N
үтә	V
миль	N
абитуриент	N
куга	N
каргыш	N
конспект	N
оппонент	N
коленкор	N
сабан	N
агыз	V
фронт	N
социаль-политик	ADJ
каюлы	ADJ
өлгер	ADJ
абыз	ADJ
космополитизм	N
муссон	N
е	N
үрмәкүч	N
ласа	ADV
минимализм	N
хлороформ	N
ниргә	N
металл	N
багла	V
тырмалат	V
базык	ADJ
сәламлә	V
крепдешин	N
зәнки	ADJ
кайма	N
алабуга	N
библиограф	N
натураль	ADJ
ясан	V
парламентарий	N
урам	N
астма	N
укалан	V
диафильм	N
беравык	ADVV_NEG
инә	N
кимер	V
озынаяк	N
фестиваль	N
контраст	N
лобогрейка	N
Шмчәк	N
җөплә	V
ябыштыргыч	N
башы-актыгы	N
ямьшек	ADJ
яшьсен	V
каза	N
иске	ADJ
грифель	N
кузгалак	N
коронка	N
сукмак	N
мал-туар	N
дидактика	N
өчлә	V
анатом	N
шешәдәш	N
шәмәхә	ADJ
әллә	PN
вакансия	N
манеж	N
кырлан	V
махинация	N
сорнай	N
легальлә	V
музыкаль-әдәби	ADJ
тартын	V
слесарь	N
заготзерно	N
пасьянс	N
шпилька	N
флора	N
бәртәс	N
кулиса	N
җикән-камыш	N
панбәрхет	N
пион	N
троцкийчы	N
озат	V
үткәрт	V
артиллерист	N
чалмабаш	N
бүз	N
омонимик	ADJ
кырыктартмачы	N
комбинат	N
лезгин	N
чиктәш	N
комплект	N
алан-йолан	ADV
апостол	N
кызыллан	V
молибденит	N
инша	N
транквилизатор	N
дезинтеграция	N
өфлә	V
алмачуар	ADJ
парткабинет	N
агрессив	ADJ
беркая	ADVV_NEG
бөршәй	V
галстук	N
өчтомлык	N
җәнлек	N
юашлат	V
эвакопункт	N
апартамент	N
тинтерәт	V
мөртәт	ADJ
эвфемизм	N
компенсациялә	V
быжылда	V
әйләнмә	ADJ
чорма	N
доклад	N
сана	V
чыркылда	V
чапылдат	V
йомыкый	ADJ
анафема	N
дивизия	N
най	N
альдегид	N
препозитив	ADJ
кант	N
уңайсызлан	V
айныткыч	N
калий	N
мөңрә	V
магнолия	N
сиплән	V
черчет	N
шелтә	N
физмат	N
ябага	N
хезмәттәш	N
хроникер	N
арык	V
привод	N
чәперчек	N
өстәл	N
миниатюр	ADJ
юша	V
Шсемлә	V
робот	N
өстәл	V
шалтырма	N
легенда	N
ач-ялангач	ADJ
президент	N
майсызла	V
җәйге	ADJ
вице-канцлер	N
лирик-драматик	ADJ
Шркәм	N
кырлач	N
текәл	V
халыкара	ADJ
матча	N
шәбәй	V
постамент	N
үренте	N
Шнспектор	N
хаин	N
асраучы	N
гырылдык	N
престиж	N
кыланчыклан	V
вөҗүд	N
озаткыч	N
буби	N
талат	V
ридикюль	N
ишетел	V
купы	N
соавтор	N
гомумиләштер	V
тумыштан	ADVV_NEG
тышла	V
пластина	N
туника	N
конфедерат	N
механизациялә	V
быелгы	ADJ
пөхтәлә	V
айнык	ADJ
һәвәскәр	N
нәҗес	N
метафизика	N
йөзтүбән	ADV
вентиляция	N
экстремаль	ADJ
интеллигент	N
ырып-ерып	ADVV_NEG
тартынкы	ADJ
баҗа	N
ротатор	N
штамплан	V
Шмана	N
кылтык	ADJ
физиотерапевт	N
түбән	ADJ
валик	N
гонорар	N
башбаштак	ADJ
нормальләштер	V
кабель	N
манометр	N
коммунар	N
ангар	N
хутор	N
сеңлем	ADV
пиктографик	ADJ
җилтерә	V
сүлпәнлән	V
үзгәр	V
кешечел	ADJ
мусс	N
үтәдән-үтә	ADV
ыжгыр	V
беркетмә	N
антропологик	ADJ
әйтем	N
авырай	V
көялә	V
ышандыр	V
пари	N
антисемитизм	N
куфи	N
пинчер	N
бәясезлән	V
паникер	N
хакла	V
спираль	N
җанкай	N
карасулан	V
словен	N
шук	ADJ
канцлер	N
мокыт	ADJ
кәмаләт	N
кокос	N
прополис	N
гөлбәч	N
тиңдәш	ADJ
парта	N
дипломатия	N
кинәт	ADVV_NEG
рейтуз	N
экзогамия	N
семинария	N
хартия	N
аллитерация	N
җәберлә	V
шпулька	N
киндераш	N
россия	N
монахиня	N
колун	N
чәүчәләклән	V
грелка	N
топонимик	ADJ
күптармаклы	ADJ
азан	N
ротор	N
буржуаз-демократик	ADJ
гидравлик	ADJ
кода-кодагыйлар	N
саркастик	ADJ
кимә	N
җемелдек	N
конвенция	N
ил-йорт	N
ростбиф	N
чөмерт	V
тау	N
рыцарь	N
каешла	V
инан	V
өстерәл	V
садист	N
гелиотроп	N
генератор	N
язмала	V
клиник	ADJ
май	N
рифма	N
кадр	N
кара-кучкыллан	V
сихерлән	V
резина	N
үкчә	N
кияүлә	V
коч	V
ташаяк	N
тораташ	N
апофеоз	N
кош-корт	N
беркөнге	ADV
шымчыла	V
күбәләк	N
кирәмәт	N
хәситә	N
карбыз	N
ярсыт	V
органик	ADJ
зарарлан	V
иминлән	V
бензол	N
прогрессив	ADJ
көрд	N
әрем	N
үткенлә	V
проекция	N
камера	N
кычын	V
абайла	V
бинар	ADJ
ләббәйкә	N
экспедиция	N
утырма	N
беркайчан	ADV
олыс	N
әстерхан	ADJ
митингла	V
җимерек	ADJ
йом	V
тмин	N
бисквит	N
яманат	N
скат	N
туздыр	V
лишайник	N
авиазавод	N
мыеклач	N
фотокүргәзмә	N
күрше-күлән	N
премьер-министр	N
транс	N
электровоз	N
йомгаклан	V
эсселә	V
олыгайт	V
рокировка	N
алпан-тилпән	ADV
рәнҗе	V
хитон	N
каш	N
чикылда	V
адресла	V
соңгы	ADJ
корыт	V
хакында	POST
авиаразведка	N
купшы	V
кисмән	N
йозакла	V
җанаш	N
стахановчы	N
көязлән	V
кутан	N
таныклык	N
шиблет	N
эпика	N
тыйгысыз	ADJ
физиотерапия	N
импрессионист	N
сан	N
неврастеник	N
читен	ADJ
шовинизм	N
как	V
мәдәният	N
ямансула	V
матавык	ADJ
шундагы	ADJ
түнкәр	V
ифтар	N
легализация	N
бШт	N
контаминация	N
шурф	N
революцион	ADJ
аеры	ADV
аудар	V
беләксә	N
карабин	N
зәмһәрир	N
илаула	V
кырчыл	N
хаки	ADJ
карагруһ	N
нәкышлән	V
кыйбатсын	V
телецентр	N
күңелсезлән	V
барышлый	ADV
Шркәлән	V
атлетика	N
Шптәш	N
фитин	N
контроль	N
кворум	N
кетгут	N
тач	ADV
чыганак	N
консерватизм	N
люстра	N
сөй	V
приоритет	N
целлулоид	N
әрне	V
тыгынчык	ADJ
боер	V
механотерапия	N
катылан	V
китапчалап	ADV
гомум	N
меню	N
оячык	N
авиабомба	N
физиономия	N
тапир	N
кырынай	V
аммоний	N
радикулит	N
зонтик	N
ветеринария	N
анапест	N
телефон-автомат	N
архимандрит	N
тәмләт	V
чәберчек	ADJ
чиркәү	N
чаларт	V
нәзегәйт	V
тумба	N
бетчә	N
җәптәш	N
демонстрация	N
жакет	N
фәрман	N
юрган	N
мохер	N
андый-мондый	PN
чеби	N
мыгырдык	N
люцерна	N
мирра	N
мөәннәс	N
Шл-йорт	N
автократия	N
миграциялә	V
электромагнит	N
эмбриология	N
тәрәш	N
почмакла	V
акрынайт	V
диахрония	N
лоджия	N
хуплат	V
орын	V
аудитор	N
ләззәт	N
кекс	N
беллетристик	ADJ
грейдер	N
Шравыл	N
иртәле-кичле	ADV
дефицит	N
пөхтә	ADJ
финал	N
баварияле	N
автоцистерна	N
корыч	N
Шңбаш	N
Шреш	V
культурала	V
программа	N
Шнтервью	N
һуш	N
субботник	N
ирмәк	ADJ
казак	N
шупырдат	V
котомка	N
сектор	N
юрат	V
чынла	V
хәзерлек	N
хосусан	ADV
хикәя	N
сырлат	V
библиотека	N
чабу	N
шакал	N
кызыклан	V
кәшәнкә	N
яшьнә	V
кыркы	V
субатом	N
тува	N
җыен	V
ярлыка	V
капсул	N
мәшгулият	N
җыен	N
некрополь	N
сәйяр	N
җентекле	ADJ
литраж	N
аномаль	ADJ
кулагай	N
иваси	N
кабар	V
такелаж	N
капшан	V
репрессив	ADJ
фоторәсем	N
популяр	ADJ
аксессуар	N
биздер	V
сугыштыр	V
беркайда	ADVV_NEG
цикл	N
дактиль	N
ярымфинал	N
сеңгер	V
иртәлек	N
хәзинәдар	N
төкер	V
менгер	V
гуашь	N
кизәк	N
триоксазин	N
факультет	N
якут	N
түшәл	V
газета	N
кульминация	N
тимурчы	N
тук	ADJ
күперенке	ADJ
фашист	N
чыгарма	N
африкалы	N
каенана	N
кәтүк	N
җилләт	V
үләт	N
калеб	N
әче	V
сөйрәл	V
соңгылык	N
крендель	N
поликлиника	N
сарказм	N
антрацен	N
фототелеграф	N
комбат	N
катыргы	N
межелдә	V
аныкла	V
кыраула	V
сүләмә	N
булан	V
грунт	N
киңәйтел	V
селтелә	V
капюшон	N
центрифуга	N
фрезер	N
прокламация	N
йомгакла	V
гидрология	N
даула	V
поляризация	N
инеш	N
Шсән	ADJ
куп	V
торгыз	V
әйттер	V
чалар	V
тревога	N
коммунизм	N
симуляция	N
әхвәл	N
көбәк	N
хәрабә	N
баглан	V
кичәле-бүгенле	ADV
пароль	N
джинсы	N
мальтузианлык	N
тапшыргыч	N
концертино	N
җәп	N
практик	N
салула	V
трюмо	N
шарф	N
ребус	N
зәмзәм	N
куратор	N
туннель	N
нурлан	V
күгәрек	N
тутыя	N
төрле	ADJ
җайлан	V
бичара	N
тузынкы	ADJ
байбәтчә	N
фарт	N
чайкалдыр	V
колонизатор	N
деформациялә	V
ложа	N
котыртык	ADJ
коляска	N
алтакта	N
фельдфебель	N
яфраклан	V
бөркел	V
ботка	N
терпентин	N
ләкләк	N
изел	V
каземат	N
өз	V
курс	N
табигый-фәнни	ADJ
ярамсак	ADJ
кысанла	V
сөйрә	V
чыт	V
пропаганда	N
культура	N
озай	V
адәм	N
салкынай	V
кугуар	N
нотариаль	ADJ
төксе	ADJ
субтропик	ADJ
шыкырда	V
бә	PN
интервенция	N
сафландыр	V
вельвет	N
Шмам	N
кушбугаз	N
дидактик	ADJ
компетентсыз	ADJ
гидравлика	N
балавыз	N
күбәйт	V
традиция	N
күмер	N
учлам	N
дуңгызлан	V
тотрыклылан	V
берәм-сәрәм	ADV
омофон	N
көшел	N
шайтанлан	V
орангутанг	N
күптонналы	ADJ
комбайн	N
текә	V
чәрелдә	V
либераль	ADJ
берәмләп	ADVV_NEG
версткала	V
Шслах	N
гарант	N
сандугач	N
аңарчы	ADVV_NEG
ялт	ADVV_NEG
тШ	V
авырла	V
нормаль	ADJ
керамик	ADJ
тан	V
бәйләнчеклән	V
әрекмән	N
нефтепродукт	N
ингаляция	N
көпшәклә	V
ачын	V
мәктүп	N
шатландыр	V
ракета	N
тәвәккәллә	V
шШ	ADJ
чума	N
сума	N
лирик	ADJ
конфуз	N
аулак	N
винегрет	N
идеаллаштыр	V
берәмтеклә	V
касса	N
озакла	V
алтынла	V
накладной	N
Шгәр	N
динамика	N
бәллүр	N
фок-мачта	N
фактура	N
көрлек	N
Шл-көн	N
үрмәле	ADJ
лемур	N
сөйгән	ADJ
диспропорция	N
үләң	N
мукшы	N
барокко	N
Шлаула	V
тынчы	V
башлат	V
пышылда	V
раунд	N
радиорепортаж	N
инкарьла	V
джунгли	N
шәбәйт	V
оя	N
явызла	V
инсафлан	V
фәнни-тикшеренү	ADJ
агробиология	N
шакмакла	V
алдап-йолдап	ADVV_NEG
зиннәт	N
искер	V
прическа	N
продотряд	N
ардак	N
язгы	ADJ
углан	N
чапкыч	N
ябын	V
кипшен	V
төтә	V
сигма	N
ятимханә	N
димедрол	N
комай	ADJ
патентла	V
комментарийла	V
виски	N
буй	N
чакырт	V
спирт	N
сок	N
лаек	ADJ
нәүрәп	N
антарктика	N
саек	V
армый-талмый	ADVV_NEG
орнаменталь	ADJ
кантата	N
вече	N
кичлек	N
шакмаклан	V
күчергеч	N
акбурла	V
әнкә	N
сфинкс	N
бәйнә-бәйнә	ADV
күмәртә	N
ачыкла	V
Шкейөзлелән	V
дөпелдәт	V
көянәк	N
шантаж	N
зона	N
терроризм	N
төстәш	N
әртил	N
җенси	ADJ
уйлат	V
бигуди	N
иләс-миләс	ADJ
күмәклә	V
чүлмәк	N
калькулятор	N
басмала	V
промилле	N
кашалот	N
кулбау	N
паек	N
берәм-сәрәм	ADVV_NEG
философия	N
конвоирла	V
вакла	V
адыгей	N
очерк	N
кубалы	N
салпы	ADJ
ысылдавык	N
мөсафир	N
манихейлык	N
төргәк	N
өслүп	N
эстә	V
надзиратель	N
эвольвента	N
мидия	N
топография	N
пеликан	N
пессимист	N
чәйхур	N
туңдыргыч	N
полинезия	N
шайба	N
әхлак	N
тазар	V
аерт	V
зерә	ADV
төчкерт	V
дөбердәт	V
кибернетика	N
траур	N
такылдат	V
киночелтәр	N
ваемсызлан	V
чәбе	N
бутил	N
үзбелдеклелән	V
ян-як	N
аналитик	N
сандал	N
бөклән	V
термометр	N
түбә	N
фотозурайткыч	N
коргаксыт	V
моңарчы	ADVV_NEG
апай	N
бөрке	V
качак	N
кобага	N
унисон	N
гаҗәпсен	V
панариций	N
лазурит	N
кайман	N
машинистка	N
смерд	N
позитрон	N
жирәбә	N
мөдир	N
әдеп	N
инкрустация	N
үтешли	ADV
бетчәлә	V
дүләнә	N
бомба	N
вәзем	N
баркас	N
аңлашылмаучанлык	N
җШрлә	V
элеккеге	ADJ
штемпель	N
декламатор	N
шпангоут	N
парфян	N
бадминтон	N
ноктюрн	N
рейд	N
типик	ADJ
моллюск	N
ычкын	V
мыркылдык	ADJ
ревизиялә	V
берәм-берәмләп	ADV
миастения	N
чыршын	N
сөяркә	N
бозык	ADJ
делегация	N
күчен	V
сөрхәнтәй	N
күзәтмә	N
филер	N
орфография	N
песи	N
дәртләндергеч	ADJ
транскрипция	N
мыскал	N
йөгереклән	V
чыгыл	V
юп	PREF_ULTRA
либретточы	N
гранд	N
репрессия	N
кыерла	V
конвульсив	ADJ
комсостав	N
шикәр	N
эстамп	N
аер	V
киленчәк	N
питомник	N
ассистент	N
урна	N
юкагир	N
компартия	N
Шхтыяҗ	N
җөй	N
китмәнлә	V
турта	N
металлист	N
тәнкыйтьлә	V
тәнкыйтьчел	ADJ
санамыш	N
кышлак	N
өйдер	V
үзкыйммәт	N
урна	V
бәбкә	N
донжуан	N
тезел	V
кардиолог	N
пунктуаль	ADJ
максимум	N
сыйфатлама	N
бәялән	V
баб	N
бум	N
бШш	NUM
Шзмә	N
гомумсоюз	ADJ
планетар	ADJ
сеньора	N
угры	N
шәхсШ	ADJ
фальсификация	N
бронза	N
шарылда	V
префект	N
ырымлат	V
орок	N
демарш	N
сарылан	V
подхалим	N
конторчы	N
шушылай	PN
будуар	N
спектр	N
укыттыр	V
йод	N
панамка	N
нирвана	N
купюра	N
чыбылдык	N
сөрәкә	N
па	N
лыкма	N
исем-чап	N
каклавыч	N
түзем	ADJ
игәр	N
клерк	N
кайтар	V
фарс	N
опека	N
кайнарлат	V
алсу	ADJ
үгилә	V
сытыл	V
арест	N
соцстрах	N
кровать	N
Шренчәклек	N
туш	N
регистратура	N
корымла	V
сыкы	N
корычлан	V
контекст	N
театр	N
Шдеаль	ADJ
библия	N
мәхәллә	N
австралия	N
капма-каршылык	N
кнопка	N
буржуаз-милли	ADJ
фашистла	V
шыл	V
лира	N
каратель	N
продналог	N
антологик	ADJ
клумба	N
аллегро	N
туташ	N
кивер	N
ләңкә	N
топограф	N
арткы	ADJ
шытырдат	V
кабатла	V
шаһиншаһ	N
агротехника	N
политикан	N
завком	N
резонатор	N
палеограф	N
күндәм	ADJ
күпкырлы	ADJ
әшнә	N
кәмал	ADJ
суахили	N
өченчеләй	ADV
котанай	N
фортуна	N
урал	V
декан	N
берсүзсез	ADVV_NEG
кепка	N
эзлән	V
тәгам	N
селәгәйлән	V
фольклористика	N
киножурнал	N
филантропия	N
винт	N
ашат	V
Шзафә	N
мәрмәрлә	V
лиана	N
бишкуллап	ADVV_NEG
калькуляция	N
пневматик	ADJ
матрицала	V
хлорофос	N
тоташлык	N
кирәк	ADJ
каерт	V
җигүле	ADJ
диссертант	N
бифштекс	N
бантла	V
мәни	PN
белгерт	V
мөмкинчелек	N
җыйма	ADJ
күк	ADJ
период	N
карачкы	N
конфронтация	N
көлке	N
терлек	N
Шшарә	N
магнето	N
һава	N
теолог	N
үлчәмле	ADJ
теплушка	N
казна	N
активист	N
аттестациялә	V
диктор	N
морфема	N
сарыл	V
сылу	ADJ
диатез	N
рәсмилә	V
славян	N
великорус	N
кануни	ADJ
экспонат	N
шпицрутен	N
җилән	N
электрон	N
төзә	V
хыял	N
коллекция	N
мишень	N
такыя	N
кыргыч	N
талаула	V
селедка	N
кирәүкә	N
яргыч	N
гормон	N
концентрациялән	V
душ	N
этимология	N
сәдака	N
мәҗрух	N
дәрвиш	N
кыртыш	N
элеватор	N
фреска	N
голкипер	N
сату-алу	N
теплица	N
дорфалан	V
дәлилсез-нисез	ADJ
ыргым	N
коллегия	N
күпшен	V
пәрилән	V
ялбыр-йолбыр	ADV
массаж	N
эгоизм	N
кытыршы	ADJ
билгеләгеч	N
меңаяк	N
френч	N
диагноз	N
экспромт	N
дезинфекция	N
борчыл	V
борау	N
зенит	N
әверелдер	V
томанла	V
чумак	N
чук	N
фотоматериал	N
католик	N
футурист	N
фокусла	V
киҗе-мамык	N
ятаган	N
курьер	N
тибрәт	V
күзчә	N
туглан	V
бала-чага	N
горизонт	N
сөрген	N
грипп	N
майла	V
тарпан	N
чокырайт	V
корчаңгыла	V
ә	N
җилпәгеч	N
кеш	N
порт	N
алу-бирү	N
ярарлык	ADJ
аергыч	N
әдәп	N
балан	N
көпә-көндез	ADV
автономлы	ADJ
таякчык	N
мина	N
инҗил	N
типкен	N
чарыс	ADJ
кәлтә	N
төтәт	V
бичә	N
Шсбат	N
сыра	N
ракетница	N
майлан	V
карават	N
танин	N
террорист	N
косметика	N
кәкрәйт	V
пластырь	N
ямьсезлә	V
йөдә	V
шизофреник	N
лангет	N
кабан	N
библиотекарь	N
киңәш-уңаш	N
конкурс	N
каз	N
тамгалан	V
ненец	N
барымта	N
тәгәрәй	N
гармоника	N
бишпочмак	N
сирень	N
тәпән	N
завод	N
эмфатик	ADJ
ил-күрше	N
тәмле	ADJ
официант	N
санузел	N
кинодрама	N
кафтан	N
җилаяк	N
носилка	N
репетиция	N
култыкла	V
алпар	N
сәхтиян	N
кысыл	V
кискен	ADJ
икелән	V
хронографик	ADJ
җизбаш	N
нотык	N
табибә	N
кинәттән	ADV
яртылай	ADV
мачин	N
муенса	N
төгәллә	V
яллат	V
микрокисәкчек	N
маг	N
никель	N
эскертлән	V
Штек	N
корык	N
юка	ADJ
тырпайт	V
рубка	N
тубыр	N
ятсын	V
талкыт	V
прииск	N
киләп	N
хөрәсән	N
хәрам	ADV
коррекциялә	V
җыйна	V
юха	N
исем	N
илгизәр	N
иң	N
ая	V
корд	N
дерелдәвек	N
ая	N
көмешлән	V
ахыр	N
шыкрай	V
сизгер	ADJ
төчкерен	V
пастор	N
галибанә	ADV
словак	N
сырла	V
мыскылла	V
рота	N
проводник	N
кирәксен	V
кристалл	N
лакылда	V
гайдук	N
әтәч	N
селектор	N
җик	V
указ	N
күксу	ADJ
Шкс	N
презумпция	N
күм	PREF_ULTRA
котсызла	V
каената	N
Шмлә	V
ралли	N
янтай	V
әвәлән	V
чаптар	ADJ
комбиазык	N
кап	PREF_ULTRA
гринвич	N
армый-талмый	ADV
тюркология	N
сурәтлән	V
корректив	ADJ
циста	N
акын	N
кабарын	V
яңалиф	N
геодезия	N
эвакуациялән	V
шток	N
радий	N
полиартрит	N
телем	N
пакь	ADJ
укол	N
бәлшәй	V
гипноз	N
мәзәкчән	ADJ
генерал-майор	N
берлә	V
саңгыраулан	V
тәрәзә	N
чәчрәт	V
туарыл	V
гипотенуза	N
күзлә	V
җепселлән	V
томрай	V
өр	V
телеграмма	N
талчыктыргыч	N
шафран	N
соса	N
дубль	N
экземпляр	N
локатор	N
ютәллә	V
кәп	PREF_ULTRA
блондин	N
титак-титак	ADV
хамелеон	N
тимер	N
көрпәлә	V
сөрмә	N
сылан	V
купон	N
ярма	N
чагыштыргы	ADJ
нитроглицерин	N
кәпәрен	V
олысымаклан	V
яшьтәш	N
акыллылан	V
карболка	N
шөшлә	V
прогрессивка	N
иге-чиге	N
фок	N
юпитер	N
пенопласт	N
аксым	N
әдрәс	N
выжла	V
ак	ADJ
транспортир	N
бүлем	N
лаборатор	ADJ
көнлә	V
мәдәни-сәяси	ADJ
телогрейка	N
бүлтәйт	V
босоножка	N
күнлә	V
кулдаш	N
ходай	N
метафоралаштыр	V
туткыл	N
хаҗәт	N
фракияле	N
чүплә	V
буденовка	N
ваза	N
торгын	ADJ
мыштым	ADJ
чинар	N
гимнастик	ADJ
канчык	V
карикатура	N
салым	N
этлә	V
күплек	N
колосс	N
кәслә	V
иңгә-иң	ADVV_NEG
гозерлә	V
тигәнәк	N
түбәтәй	N
мушка	N
центнер	N
әзерлә	V
таҗчык	N
патриарх	N
укырдай	ADVV_NEG
конка	N
кабырга	N
шаккатырырдай	ADJ
сөял	V
чалгыч	N
суыргыч	N
бөрмә	N
кондитер	N
фюрер	N
зәгыйфь	ADJ
партер	N
тромб	N
берләшмә	N
пантомима	N
саркы	V
сабакташ	N
диктант	N
эффект	N
зыянла	V
сөял	N
дөресләт	V
наган	N
типография	N
культурник	N
иген	N
вакчыллан	V
табыр	N
тымызык	ADJ
рекламация	N
футляр	N
чытыр-чатыр	N
шәлперәй	V
кытакла	V
шаңгырдат	V
шпиц	N
гайдамак	N
дугайлан	V
мәрҗән	N
үт	V
куела	V
энергетика	N
яткыз	V
Шкеләт	V
сәфәр	N
норман	N
шәүлегән	N
алкышла	V
арата	N
талык	V
тарсын	V
чүк	V
тасмала	V
мондый	ADJ
ванна	N
очлай	V
милиция	N
инквизитор	N
ил	N
көрәш-талаш	N
калып	N
мәшәкать	N
кызылгвардияче	N
авызлыклат	V
бронзала	V
утиль	N
исерт	V
тырман	V
турат	N
гудрон	N
яссылан	V
вертлюг	N
кушкуллап	ADV
тәүфыйклан	V
пегас	N
туңдырма	N
король	N
алтыпочмак	N
фидакяр	ADJ
тәкәллеф	N
чемпионат	N
полицмейстер	N
гыйфрит	N
миллионлаган	ADJ
судла	V
ныгайт	V
хөкемләш	V
эрлә	V
начарлат	V
күпчелек	N
куаклан	V
көпшәк	ADJ
кастрюль	N
шоп	PREF_ULTRA
шлюпка	N
саңак	N
статистика	N
серенада	N
психотерапевт	N
юантык	ADJ
иртәлә	V
аумакайлан	V
водопровод	N
гауга	N
саксаул	N
пасха	N
норматив	N
репродуктор	N
гортензия	N
Шл-күз	N
вельветка	N
һөнәрханә	N
апа	N
жула	V
хәйләкәр	ADJ
контузиялә	V
кадаклат	V
киртлән	V
сулыш	N
исәр	N
оһ	ATTR_ABES
методика	N
сотник	N
санитар	N
эмоциональ	ADJ
унтер	N
заряд	N
дошманла	V
оятсызлык	N
көйсезлән	V
колбиләүче	N
биохимия	N
сыпыл	V
рәхим-шәфкать	N
аел	N
Шел	V
хөсет	N
токымдаш	N
пакгауз	N
ударник	N
софа	N
прагматизм	N
чыгыр	N
әнис	N
цейтнот	N
чүке	V
ыспай	ADJ
опричник	N
опись	N
классификацион	ADJ
квалификацион	ADJ
көрт	N
балансир	N
авиакомпания	N
сафьян	N
контрразведка	N
түгәрәклә	V
инкыйлаб	N
шпрот	N
корылат	V
җий	V
гөлләмә	N
гадилә	V
йомгак	N
эчке	ADJ
лә	V
сулкылда	V
дьячок	N
кинокомедия	N
кызула	V
курпы	N
ханә	N
күкселлә	V
ажгыр	V
җыелма	N
апаш	N
судья	N
тәтелдә	V
сван	N
лә	N
ачу	N
түрә	N
балчыксыл	ADJ
юкә	N
македонияле	N
карьерист	N
мүлчәлә	V
плюсла	V
ария	N
хәзрәт	N
матавыкла	V
исән-сау	ADJ
каешлан	V
мескинә	N
сул	V
вахмистр	N
экономка	N
монументаль	ADJ
чәчби	N
карама	N
түбәнәй	V
кузаклан	V
куртка	N
травма	N
аксеркә	N
уку-укыту	N
дикция	N
сасы	ADJ
консервациялән	V
горур	ADJ
тирә-күрше	N
тәмсезлән	V
меридиан	N
очсызлан	V
иген-тару	N
дәресханә	N
торгынлык	N
сүрәнәй	V
хислән	V
фанфара	N
авырттыр	V
илт	V
комиссион	ADJ
боржом	N
рифмадаш	N
шишак	N
сөремлән	V
обком	N
холкы	PN
паром	N
ихтираз	N
төтенлән	V
фронтташ	N
соната	N
ухват	N
ихтирам	N
фиктив	ADJ
эвенк	N
булавка	N
астролог	N
клиник-диагностик	ADJ
зырлат	V
болга	V
тыпырда	V
бюллетень	N
ретрансляция	N
жу	CNJ
Шр	N
ял	N
манго	N
кимия	N
утыз	NUM
кибән	N
саранла	V
гүрлә	V
быдырда	V
энекәш	N
чемчеклә	V
империалист	N
әвәрә	N
көл	N
пасквиль	N
каракүл	N
машина-трактор	ADJ
күчер	V
баштанаяк	ADVV_NEG
регламент	N
япсар	V
өянке	N
аппетит	N
арпа	N
кыскартылма	ADJ
мичәү	N
дегенератив	ADJ
алды-артлы	ADJ
Шкәүләшеп	ADV
көл	V
тула	N
укыл	V
карыш	V
Шсерт	V
токсин	N
мультимиллионер	N
амфибия	N
мозаика	N
моңарчы	ADV
букинистик	ADJ
трансляциялә	V
этнография	N
чапан	N
бөтенләтә	ADV
Штагать	N
намуслан	V
театрлаштыр	V
башлангыч	ADJ
канцелярия	N
хәзер	ADVV_NEG
төргәклә	V
юньлән	V
каралай	ADV
буразна	N
шыбын	N
биштәр	N
имитация	N
структурализм	N
синагога	N
яньчет	V
болгатма	N
корзин	N
тупылда	V
көянтәлә	V
нәзер	N
немецла	V
конфигурация	N
география	N
толь	N
җайсызла	V
хикмәт	N
финляндияле	N
шым	ADV
табын	N
волейбол	N
киртлә	V
лөгать	N
ачык	ADJ
пычрак	ADJ
кол	N
картон	N
фермент	N
хупла	V
тиле-миле	ADJ
пантюркизм	N
пикник	N
рәтсезлән	V
чокыр	N
пресса	N
себерке	N
ратуша	N
косметология	N
сабантуй	N
тенор	N
канык	V
куп	PREF_ULTRA
танкист	N
бронепоезд	N
репутация	N
лаштырда	V
педпрактика	N
дебютант	N
тамбур	N
завхоз	N
чеметем	N
черлә	V
тагылма	N
чыбык	N
рационалист	N
хәтерләт	V
чапкын	N
гараиб	N
көндәлек	N
шоссе	N
декларация	N
кыштырда	V
япа-ялгыз	ADJ
канәфер	N
администратор	N
миллион	NUM
ромб	N
тоба	N
яланкул	ADVV_NEG
кайчакларда	ADV
күкәй	N
стеллаж	N
җыенкы	ADJ
картежник	N
ап-ачык	ADJ
тоем	N
хирыслан	V
капкач	N
цезура	N
романистика	N
турысызыклы	ADJ
спазма	N
һавала	V
чирек	N
һич	PN
литавра	N
дивана	N
сыгылма	ADJ
хортум	N
ашадан-аша	ADV
читлек	N
биатлон	N
социаль-көнкүреш	ADJ
стюардесса	N
анкета	N
ямал	V
чыгышлый	ADV
космонавт	N
чиновник	N
вульгарлаштыр	V
титул	N
тәгәрәт	V
подряд	N
сирәгәйт	V
нарат	N
саналмыш	N
җитен	N
ура	V
испанияле	N
фитофтора	N
палиндром	N
хурла	V
җШллә	V
сон	V
авызлыклан	V
атомоход	N
дегет	N
картлач	N
алкала	V
потенция	N
туп	PREF_ULTRA
борылмалы-сыгылмалы	ADJ
фальсификациялән	V
тилебәрән	N
уен-көлке	N
линия	N
мамыклан	V
мулла-мунтагай	N
юридик	ADJ
әмир	N
провинция	N
сыр	N
токарь	N
алдавыч	N
консультатив	ADJ
төп	PREF_ULTRA
чаптыр	V
такмак	N
такта	N
гаять	ADVV_NEG
реалист	N
политрук	N
моменталь	ADJ
ничья	N
хакыйкать	N
өркәк	ADJ
тунгус	N
кадак	N
дымлан	V
төмсәлән	V
кукрайт	V
шомырт	N
өске	ADJ
ләкин	CNJ
электромонтаж	N
төкерек	N
антиквар	ADJ
трансформатор	N
типологик	ADJ
җәзбә	N
энклитика	N
карбид	N
йончыл	V
куырма	N
сүгел	V
тюль	N
тәбәлдерек	N
искитмәле	ADV
үтә	ADV
каньон	N
ирексезлә	V
теген	V
болак	N
текстолог	N
шыртлака	N
саегай	V
арбитраж	N
радар	N
сәясШ	ADJ
калкавыч	N
баррикадала	V
кызык	V
лексик	ADJ
җиңеләй	V
оппозиционер	N
йон	N
айбагар	N
помпон	N
максималист	N
критик	ADJ
медперсонал	N
көйрә	V
гамәл	N
сихерләт	V
койрык	N
тоткар	ADJ
Шсәнлек	N
медиатор	N
Шдеал	N
үбештер	V
дебит	N
кырыл	V
мазар	N
Шҗат	N
күпләгән	ADJ
армас-талмас	ADJ
тенте	V
җиз	N
арындыр	V
тизәк	N
кыйгач	ADJ
пистолет	N
сизгерлән	V
акмай	N
түшәк-ястык	N
спикер	N
конденсатор	N
параллелизм	N
нокаут	N
экранла	V
җизни	N
инфильтрат	N
йомычка	N
түшәмә	N
уйнакла	V
парфюмер	N
азман	N
сестра	N
кисек	ADJ
резонер	N
таләп	N
җиңел	ADJ
алмаш-тилмәш	ADVV_NEG
бишьеллык	ADJ
газлан	V
синкопа	N
кәүсә	N
триптих	N
экспорт	N
кушла	V
лапланд	N
капелла	N
саллы	ADJ
мөштәри	ADJ
авиапочта	N
матрона	N
синтезла	V
раскол	N
ямансу	ADJ
көрәш-сугыш	N
өлгергән	ADJ
кульминацион	ADJ
автомагистраль	N
процессия	N
блокнот	N
тайгакла	V
каратут	N
җилфердә	V
әреплә	V
яракла	V
канаус	N
күтәрәм	N
тәһарәтханә	N
болт	N
барлама	N
каралты	N
раюзәк	N
җилбәгәй	N
җидегән	N
төсмер	N
буржуаз	ADJ
ташбасма	N
быжла	V
чичән	N
төссезлән	V
җылу	N
альфа	N
полоний	N
этил	N
царизм	N
аңгыралан	V
селекция	N
муза	N
каюр	N
бактерицид	N
изала	V
түбәнсет	V
ливр	N
ласа	ADVV_NEG
бишинә	N
назлан	V
хәстәрлән	V
сейсмолог	N
форсунка	N
ыспайлан	V
критицизм	N
шикчел	ADJ
экстерн	N
өтәлән	V
хач	N
муляж	N
терминла	V
яудыр	V
йөдәткеч	N
омонимия	N
кыймылдат	V
яранга	N
компас	N
премьера	N
оклад	N
крематорий	N
токсикоз	N
ярыматау	N
капша	V
ыбыр-чыбыр	N
бизән	V
эра	N
кара-чуар	ADJ
бермәлне	ADVV_NEG
усалла	V
танцы	N
көянтә-чиләк	N
лаф	N
күрпә	N
авторалли	N
миңгерәй	V
клетчатка	N
радиация	N
реконструкциялә	V
пароход	N
бина	N
калдык	N
мөхәррир	N
сызымта	N
ортопедия	N
пропилен	N
сеңлем	ADVV_NEG
алгай-салгай	ADV
сурәтлә	V
бире	PN
типтер	V
диярсең	CNJ
лениниана	N
күрсәт	V
контакт	N
холыксызлан	V
нектар	N
титаник	ADJ
фонд	N
кичек	V
агач	N
ватман	N
илһамлан	V
плексиглас	N
агай	N
композицион	ADJ
яу	V
матбага	N
чуалан	V
пансион	N
нәсел-нәсәп	N
салкынла	V
вулканолог	N
кыйбла	N
сүрү	N
тон	N
уфтан	V
директива	N
кара-катыш	N
элодея	N
тон	V
шлифовка	N
кайрат	V
субтропиклар	N
суыклан	V
императрица	N
каңгылда	V
люминофор	N
ярдәмчел	ADJ
төпче	V
карабай	N
радиатор	N
аякла	V
мәртәбә	N
кыр	N
җәпләкә	N
балкашык	N
җәяүлә	V
вагон	N
парашютист	N
гүрничә	N
тәнсакчы	N
металлург	N
кулалмашка	ADVV_NEG
амфитеатр	N
гадәләт	N
намазчыл	ADJ
реконструкциялән	V
күсәбә	N
кыр	V
кадаклан	V
тәте	N
иңкү	ADJ
холецистит	N
брошюра	N
сызла	V
тетрәткеч	ADJ
кызарын	V
аббревиатура	N
паша	N
кокс	N
каткак	ADJ
йомышла	V
шула	V
циркуляр	N
бегония	N
чыбык-чабык	N
яшелбаш	N
черелдәвек	N
биштәрлә	V
тырай	N
таптыр	V
прожектор	N
чирмеш	N
тәгаенле	ADJ
такыр-токыр	ADJ
пандус	N
дамка	N
варвар	N
агония	N
нурландыр	V
тирес	N
Шкенчелән	V
җилем	N
төчкер	V
берәрсе	PN
интернационалист	N
инвентарь	N
тилерт	V
чынаяк	N
сүн	V
имез	V
эрос	N
табыл	V
кыйгачла	V
әлбә	N
айсберг	N
помпа	N
геркулес	N
тазалан	V
бәби	N
көнкүреш	N
саескан	N
таушал	V
гарантия	N
чыра	N
символизм	N
ыргыл	V
двигатель	N
амеба	N
таскак	N
кансызлан	V
итальян	N
йөклән	V
чокыр-чакыр	N
яшелчә	N
җилгәргеч	N
серия	N
кыршаула	V
цензура	N
буйдак	ADJ
лейб-гвардия	N
ярдыргыч	N
консервла	V
төтмә	V
вафа	N
куырдык	N
округ	N
дүн	V
түшәм	N
индианка	N
фотоателье	N
матуркай	N
кафе	N
газаплат	V
үлеләндер	V
нидерланд	N
палеозой	N
караңгыла	V
атнакич	N
үлән	N
неоромантизм	N
төнлә	ADVV_NEG
анимизм	N
криминалист	N
тискәрелән	V
җәберлән	V
дискредитация	N
диод	N
ялкынлан	V
гарантиялә	V
кәс	N
дрессировка	N
актиния	N
ызанла	V
суыткыч	N
ампутация	N
индиго	ADJ
тетрациклин	N
әле	PN
пычак	N
микстура	N
нечкә	ADJ
мифология	N
форвард	N
чистарткыч	N
бизә	V
кинопленка	N
пионер	N
скважина	N
вәкыф	N
саламандра	N
ортодоксаль	ADJ
эффектив	ADJ
символистик	ADJ
узмыш	N
полифоник	ADJ
тукыма	N
реалистик	ADJ
күпләр	N
вакчыл	ADJ
аффект	N
берьюлы	ADV
өрәңге	N
надфиль	N
тансыклат	V
хорда	N
данияле	N
тикшерел	V
бабакай	N
тастымал	N
буаз	ADJ
фронтон	N
дус	N
политтүгәрәк	N
контратакала	V
пистон	N
бүлгәлә	V
стаккато	N
чШт	N
эллиптик	ADJ
токсикология	N
аеруча	ADVV_NEG
чыңгылда	V
агулат	V
вәзир	N
йөгертмә	N
бетергеч	N
кат	N
гигантомания	N
ватандар	ADJ
тулумбас	N
кат	V
төргеч	N
чалын	V
спектакль	N
яһүт	N
контрабанда	N
док	N
хроникаль	ADJ
ташкурчак	N
узышлый	ADV
шау-шу	N
ас	N
фосфорит	N
кандала	N
мичәүлә	V
парламентер	N
кыздырма	N
рам	N
мимика	N
тәшвишлән	V
операция	N
латинча	ADJ
диагностика	N
миллионер	N
эксцентрик	N
булка	N
җәнабе	N
изге	ADJ
ас	V
залим	ADJ
бур	N
миссионер	N
декларацион	ADJ
барбамил	N
танкетка	N
пресс-бюро	N
структураль	ADJ
зарык	V
морзе	N
ялла	V
ярпачлан	V
дуен	N
эшергеч	N
мокытлан	V
обойма	N
кокаин	N
межалат	V
кадерсезлә	V
интервокаль	ADJ
якала	V
эчәк	N
катыр	V
чалма	N
кингстон	N
ысла	V
штаб	N
сукбай	N
кырпак	ADJ
чабан	N
саргылт	ADJ
фирка	N
катыргыч	N
тарт	V
паркет	N
миндаль	N
кырыкмыш	ADJ
кымшат	V
схоластик	ADJ
сапла	V
сервис	N
цикада	N
технорук	N
пастернак	N
матриархат	N
гранка	N
закончалык	N
йомшат	V
беркаян	ADV
түти	N
радиотрансляция	N
марафон	N
алчак	N
белорус	N
яр	N
марионетка	N
девальвациялә	V
кәпәч	N
бүтәкә	N
сайлан	V
гәүдәлән	V
терәт	V
микадо	N
васыятьнамә	N
кодла	V
җитәклә	V
часовой	N
торпедала	V
яр	V
свитер	N
аяк-тояк	N
телемеханика	N
кубрик	N
ксилофон	N
тизлек	N
алан	N
сабаклан	V
кәкре-бөкре	ADJ
шпаргалка	N
ярыкла	V
булыщы	N
иртәдә	ADVV_NEG
ышандырырлык	ADJ
икеләт	V
баскын	N
мәхкәмә	N
үрмәлә	V
сурык	V
абыстай	N
партнерша	N
монета	N
фельдшер	N
килотонна	N
кроссворд	N
си	N
сепаратор	N
калкын	V
реконструкция	N
туризм	N
шпингалет	N
тоныклан	V
җыйнал	V
аяклан	V
вульгар-социологик	ADJ
лингафон	ADJ
зоолог	N
эзләт	V
ямьлән	V
казаяк	N
яфракча	N
си	V
бостан	N
шулкадәр	PN
углекислый	ADJ
аяк	N
кардиналь	ADJ
ибис	N
плита	N
яры	N
бетон	N
медальон	N
кеше	N
нәфислән	V
сизгеч	N
проблема	N
кайчы	N
бирмалы	ADJ
геройлан	V
публицистика	N
миграция	N
чабышкы	N
курок	N
коралл	N
технолог	N
тәһарәт	N
фатиха	N
типолитография	N
бертуктаусыз	ADVV_NEG
тырышып-тырмашып	ADV
агынты	ADJ
чагыштырма-тарихи	ADJ
детонация	N
дефект	N
әйләнчек	N
регуляр	ADJ
радиотелефон	N
кичәге	ADJ
христиан	N
радиоканал	N
дөньякүләм	ADJ
куркын	V
начарай	V
тыгызлат	V
каһарман	N
матадор	N
галәм	N
тәрҗемәи	ADJ
юаш	ADJ
купе	N
офтан	V
унарлы	ADJ
адвокатура	N
ассимиляциялә	V
заготскот	N
мех	N
сенсация	N
ментол	N
өрлек	N
увертюра	N
сумала	N
тигезлә	V
мультфильм	N
илек	N
дусла	V
чарла	V
иллюзор	ADJ
тугра	N
берәм-сәрәмләп	ADVV_NEG
лШфт	N
карурман	N
пенал	N
Шкәүләшеп	ADVV_NEG
шкатулка	N
саплам	N
ашар-ашамас	ADJ
көпшәклән	V
барак	N
Шнформатор	N
раслык	N
кире	ADJ
ис-аң	N
студентка	N
трикотин	N
грамматика	N
димче	N
мөкатдәс	ADJ
кылмыш	N
төнбоекчалар	N
фотография	N
командировка	N
зәгыйфьлән	V
ресторан	N
синкретизм	N
княгиня	N
тиргән	V
сусаклагыч	N
гроссбух	N
группадаш	N
колер	N
вундеркинд	N
тыкырдат	V
бетле	ADJ
матурлат	V
сәнәгать	N
уенчык	N
шешә	N
блокла	V
оториноларинголог	N
нәшир	N
трансляциялән	V
һун	N
расла	V
психоаналитик	ADJ
пипелдә	V
исән-имин	ADJ
контаминациялә	V
рәҗәп	N
кобура	N
пехота	N
аваздаш	N
декстрин	N
лиман	N
кратер	N
бүсер	N
чукынчык	N
мата	N
электрокар	N
кисмә	ADJ
брутто	N
музыка	N
интродукция	N
кайчагында	ADV
Шсәнгерә	V
сюрприз	N
кардәш	N
Шртәме-соңмы	ADVV_NEG
беткесез	V
бакенбард	N
суер	N
кардәшлә	V
герметик	ADJ
атакай	N
үсен	V
колынчак	N
чаптырда	V
уку-язу	N
купайлан	V
португал	ADJ
вакцинация	N
концовка	N
эңгер	N
керешли	ADV
төрек	N
нәкыш	N
политолог	N
ыжла	V
реалия	N
танбур	N
политика	N
туристик	ADJ
бертуктамыйча	ADVV_NEG
пневмония	N
гипотеза	N
инициал	N
политик	ADJ
метеорологик	ADJ
трал	N
җирәнеч	ADJ
антилопа	N
карачкыллан	V
күлләвек	N
метиламин	N
княжна	N
кремациялән	V
ампутациялә	V
коркылда	V
пытырда	V
блицкриг	N
тирләт	V
пластика	N
шакылдат	V
юбалгы	ADJ
читлә	V
йомар-йоммас	ADJ
йөгән	N
синдром	N
кәмитлән	V
лепкә	N
күптин-күп	ADV
боргалан	V
скарлатина	N
зәррә	N
фильтрла	V
бозваткыч	N
кишер	N
бердәнбер	N
ал-ял	N
каккала	V
шүре	N
нәфес	N
салака	N
гранд-дама	N
ялын	V
унтугыз	NUM
пиджак	N
лайла	N
типаж	N
анаграмма	N
Шмпорт	N
тый	V
өтеклә	V
тәсбих	N
петербурглы	N
күкелдә	V
партвзнос	N
ятимлек	N
юра	V
шарай	V
бастырынкы	V
демаркация	N
сагайт	V
җәфалан	V
ордер	N
лунатик	N
түбәләт	V
спортлото	N
вак-төяк	ADJ
хәрәкәт	N
вояж	N
пеня	N
гидромелиорация	N
диалогик	ADJ
тубылгы	N
кәкре	ADJ
бодай	N
квитанция	N
коллизия	N
левиафан	N
пролетарла	V
черкас	N
радиокомментатор	N
кытыклан	V
җебегән	ADJ
тыпылда	V
атлет	N
кимсет	V
могикан	N
астероид	N
торма	N
оешма	N
шөпер	V
сызлавык	N
сүл	N
багалма	N
чөнки	CNJ
саргай	V
материаль	ADJ
салат	N
яратырдай	ADV
приказ	N
ләхет	N
Шннек	N
чехолла	V
бутон	N
эл	N
бугай	CNJ
кытык	N
төксәр	V
йорт-каралты	N
нечкәлә	V
пике	N
җиткелекле	ADJ
хәлифә	N
җиһазлат	V
синусоида	N
кайшал	V
ШлгШзәр	N
контр-адмирал	N
барыл	V
ганка	N
кибәк	N
либерализм	N
шәп	ADJ
хозрасчет	N
ударница	N
оппозицион	ADJ
тирән	ADJ
арматура	N
дүрткырлы	ADJ
сөзәклән	V
мантия	N
багышлама	N
супермен	N
метис	N
тукма	V
капитал	N
капельмейстер	N
кызганыч	ADJ
Шсерткеч	ADJ
сәрхуш	ADJ
циферблат	N
утопия	N
яшертен	ADJ
сумалала	V
саргылтсу	ADJ
жандарм	N
төйгечлә	V
прицел	N
тәгаенлән	V
богема	N
перспектива	N
гидра	N
логотиплар	N
җыенысы	PN
электромашина	N
чулпан	N
рәнҗү	N
бөдрәлә	V
барышлый	ADVV_NEG
каран	V
физика	N
агрочара	N
чепилә	V
сырлан	N
бөк	V
камерный	ADJ
криминаль	ADJ
фетишизм	N
Шрланд	N
канализациялә	V
стрихнин	N
характерла	V
портатив	ADJ
интуиция	N
сафлан	V
талмуд	N
хәзерләт	V
арктик	ADJ
ничә	PN
стихия	N
тыйнак	ADJ
холык	N
метрополия	N
токым	N
ратификациялә	V
ашлама	N
нашивка	N
кадат	V
учак	N
чып	PREF_ULTRA
җетелән	V
кура	N
терция	N
сәхрә	N
аңгырайт	V
миссис	N
туфан	N
кыяфәтсезлә	V
орлыкча	N
блуза	N
метеостанция	N
карандаш	N
стеарин	N
искәрт	V
кытыкла	V
фанатик	N
гадәтилек	N
борыч	N
аптырат	V
форшлаг	N
шешенкелән	V
билет	N
пуля	N
тартма	N
рапсодия	N
борнай	V
горурлан	V
булдырырдай	ADV
бундестаг	N
концентрат	N
черелдә	V
торлак	N
ялагай	N
талаш-җәнҗал	N
күмәк	ADJ
социал-демократик	ADJ
бурсы	V
өстәт	V
сибел	V
макияж	N
Шлә	V
йогышлан	V
карцер	N
платоник	ADJ
спелеолог	N
льгота	N
кару	N
размер	N
карбинол	N
ялантәпи	ADVV_NEG
капшат	V
эксперимент	N
туфракса	N
гуҗ	N
суалчан	N
санбат	N
каталажка	N
яланкул	ADV
тәкрарлат	V
кондиция	N
уяу	ADJ
эмпирик	N
кына	N
генә	POST
көрәт	V
заграница	N
ко	N
ишеткән-белгән	ADJ
гладиатор	N
кинокамера	N
Шзге	ADJ
типке	N
модератор	N
астронавт	N
беләзек	N
шәлберә	V
комсызлык	N
Шнтендант	N
мо	PN
фида	N
димчелә	V
вәсвәсә	ADV
алам-салам	ADJ
төрки	N
бытбылда	V
вегетация	N
корнет	N
хушлан	V
сайра	N
сызгыр	V
типология	N
дөрес	ADJ
член	N
берсе-берсе	PN
чүгәлә	V
индекс	N
полиглот	N
латук	N
фимиам	N
игрек	N
карыш	N
патока	N
беләү	N
көйдергеч	N
сизен	V
империалистик	ADJ
халкы	PN
кинә	N
корама	N
кимек	N
сызыкча	ADJ
вертикаль	N
сомбреро	N
күрәләтә	ADVV_NEG
чәнти	ADJ
туфлШ	N
иҗат	N
күлмәк-күнчек	N
кольчуга	N
кадимче	N
кавыш	V
электросварка	N
ярдыр	V
ислә	V
сискәндергеч	ADJ
поляк	N
кулак	N
тотрыкла	V
юри	ADV
полотно	N
бәлешлән	V
уклау	N
тип	PREF_ULTRA
шәльяулык	N
чигә	N
кләймә	N
пристань	N
ител	V
бута	V
анчоус	N
җәүһәр	N
тасма	N
портфель	N
туйра	N
сирена	N
почтальон	N
оппортунист	N
тегендә	ADVV_NEG
ерт	V
ыру	N
эргәдәш	N
назария	N
илттер	V
жанр	N
тәпке	N
тиргә	V
пар-су	N
йөк	N
рюмка	N
аңкыт	V
сызым	N
алдалан	V
күкшә	N
пута	N
фонарь	N
дуршлаг	N
наз	N
кеткелдә	V
калдырча	N
дебош	N
гамма-глобулин	N
номиналь	ADJ
аунат	V
чәлпәк	N
үзсүзлелән	V
азаплан	V
газон	N
шау-шула	V
сәдәп	N
вахтер	N
теодолит	N
дежур	ADJ
дилбегәлә	V
котылгысыз	ADJ
тибрәл	V
шаукымлан	V
декабрист	N
шомполла	V
тукмат	V
отставка	N
мизгел	N
секстант	N
арий	N
гимнаст	N
дебат	N
тоткарлан	V
аякчу	N
канифоль	N
шыгырдавык	ADJ
дина	N
ансы-монсы	PN
экстраординар	ADJ
тәңкә	N
агглютинатив	ADJ
рандеву	N
мәтәлчек	N
сәламәт	ADJ
автоген	N
матрос	N
пырхылда	V
иләк	N
әйбәт	ADJ
сәгадәт	N
антрепренер	N
бианай	N
соңла	V
вампир	N
шикаятьнамә	N
элегант	ADJ
гәптәш	N
исәнлә	V
күрәлма	V
яп	V
алдынгылык	N
коллегиаль	ADJ
инфекция	N
керем-чыгым	N
верстак	N
бланк	N
иртәләрен	ADV
сыйдыр	V
яртылаш	ADV
юнәлт	V
фирүзә	N
боз	N
анархистик	ADJ
интенсификация	N
рациональ	ADJ
турнир	N
джем	N
юан	ADJ
тык	V
буйлатып	ADV
подполье	N
ялгыш-йолгыш	N
җайдак	N
математика	N
үл	V
ыруг-кардәш	N
суз	V
боз	V
үсем	N
хушла	V
саңгыраулат	V
төрән	N
сәке	N
кае	V
абала	V
шылдыравык	N
адонис	N
багышла	V
стеклограф	N
монологик	ADJ
кәк	V
ихтирамчыл	ADJ
тынычландыр	V
протокол	N
сәхифә	N
касә	N
хронологик	ADJ
тузанлат	V
автомеханик	N
сикергәк	ADJ
координатор	N
керенте	N
лакмус	N
эгоцентризм	N
черепица	N
шуыт	V
үскен	ADJ
үргеч	N
мәмнүн	N
ләвәш	N
әйбер-кара	N
бала	N
лачын	N
эпоха	N
эшкәртел	V
ботак	N
намә	N
калчан	N
ассимилятив	ADJ
манифестация	N
азайт	V
коба	ADJ
край	N
литота	N
ик	V
юш	ADV
һәммә	PN
акушерка	N
челпәрәмә	ADVV_NEG
чыгымчыла	V
иренле	ADJ
тШлчә	N
таба	N
аяма	V
йортсыз-нисез	ADJ
өзәңге	N
кәрәмәт	N
бетек	N
әйбер-мазар	N
тонус	N
публицистик	ADJ
үсмер	N
авырыксын	V
каралама	N
ханым	N
пырылда	V
бусан	V
капла	V
иләк-чиләк	N
һичшиксез	ADVV_NEG
томан	N
кантком	N
иминлә	V
талку	N
яңа	ADJ
военкомат	N
зәңгелә	N
иш	V
мелиорация	N
зарури	ADJ
көйләм	N
тәкә	N
мольберт	N
иш	N
актык	ADJ
феминизм	N
бөя	N
арахис	N
кәркәдән	N
Шрексезлә	V
космодром	N
эскертлә	V
низаг	N
көтеклән	V
фосфор	N
җөйлә	V
астрономия	N
матурла	V
ышан	V
шабырда	V
һичкайсы	PN
субарктик	ADJ
конспектла	V
җыерчыклан	V
предикатив	ADJ
календула	N
китапчык	N
идиома	N
җылымсалат	V
бәслән	V
паразит	N
тавыш	N
гарәп	N
ямьшәйт	V
читенлә	V
сыегай	V
мораль	N
персональ	ADJ
маңгыт	N
иртәнгәчә	ADVV_NEG
министр	N
казык	N
кәшә	N
бөтенсоюз	ADJ
синтагма	N
әрчет	V
йөгәнлә	V
арба	N
юа	N
дуга	N
җәяү	ADVV_NEG
ләхәүлә	N
күксагыз	N
азамат	N
крыжовник	N
графоман	N
кишәрлеклә	V
шәрех	N
сыйрак	N
пастель	N
матч	N
чәйнәл	V
бердәмлә	V
кеше-мазар	N
рекомендация	N
мазут	N
патологоанатом	N
Шнженер	N
кәтермәч	N
мөдәррис	N
болган	V
милитаризм	N
оч	V
кушбаш	N
кашы	V
тунал	V
булышырдай	ADV
оч	N
брезент	N
таяк	N
ышылдат	V
көфер	N
сипкеч	N
кидерт	V
имгәк	N
такырайт	V
үзбашка	ADV
бричка	N
призыв	N
Шҗатташ	N
холерик	ADJ
йөгерек	ADJ
будыргыч	N
Шҗеклә	V
шәркый	ADJ
инде	CNJ
җитди	ADJ
йөген	V
бетлә	V
пипетка	N
йөклә	V
бөклә	V
әрәм	ADJ
талгын	ADJ
яхшатлан	V
калкулан	V
кәнизәк	N
эчәк-бавыр	N
кунакханә	N
курия	N
күгәрчен	N
канечкеч	ADJ
мәмләкәт	N
үшәнлән	V
тәбрик	N
яшен	N
рабкор	N
Шлгәсәр	N
тәртиплә	V
социолог	N
блокиратор	N
австрия	N
өленге	N
бар	V
каргышла	V
навага	N
антикоммунизм	N
калейдоскоп	N
өләш	V
тырма	N
лектор	N
кавым	N
кәйлә	N
адаптация	N
гына	CNJ
аккордеон	N
булганлык	N
бар	N
картсын	V
сөземтә	N
вәгазь	N
юл	N
фикция	N
магний	N
җәтмә	N
буфет	N
Шрдәүкәлән	V
мәңгелек	ADJ
галлюцинация	N
истилах	N
билгелә	V
рухи	N
гидролог	N
кишмиш	N
сөт	N
туры	ADJ
сайрат	V
сырхауханә	N
юклык	N
спиртлы	ADJ
йодрыкла	V
калыплан	V
тотам	N
җиһазлан	V
талир	N
суырткыч	N
касторка	N
Шнкубатор	N
себерел	V
бакырла	V
фантастика	N
клуб	N
пәрвайсыз	ADJ
дьяк	N
сык	V
кафельлә	V
иртәге	ADJ
җенестәш	N
көнозын	ADVV_NEG
ашамсак	ADJ
эзоп	N
хәсрәтлән	V
куәтләт	V
селәгәй	N
ләпәк	N
квадратла	V
монополист	N
зуммер	N
буссоль	N
шпал	N
комла	V
скафандр	N
астра	N
кузы	N
биолог	N
җильяк	ADJ
программист	N
хәрам	ADVV_NEG
лыгырдат	V
сирәк-сирәк	ADVV_NEG
тончыктыргыч	ADJ
көнбагыш	N
мәчкәй	N
цирроз	N
кыңгыравык	N
оркестрант	N
кимет	V
малкуар	N
төзәтен	V
юдыр	V
коммуналь	ADJ
дуамал	ADJ
түрә-кара	N
кювета	N
швед	N
мембрана	N
энҗе-мәрҗән	N
пакт	N
болонка	N
кадер	N
кыйммәт	ADJ
кауша	V
инвестор	N
өтек	ADJ
чаккыч	N
җиңсә	N
кысынкылык	N
көпшә	N
амораль	ADJ
илаһи	ADJ
таштабак	N
биологик	ADJ
котелок	N
тизлән	V
әйт	V
алгебраик	ADJ
аспирантура	N
кытлык	N
прогулка	N
жрец	N
сәркатип	N
конфликт	N
фигура	N
тәкать	N
горн	N
бызла	V
әмәл-чөмәл	N
доминант	N
мәдәни-тәрбияви	ADJ
кама	N
иләс	ADJ
пеньюар	N
риф	N
классика	N
ветфельдшер	N
ариозо	N
бетергесез	V
чәкән	N
олугла	V
коррида	N
теплоход	N
нумерация	N
тормыш-көнкүреш	N
формуляр	N
тозакла	V
элегик	ADJ
ярым	N
коронация	N
дифирамб	N
парламентаризм	N
дөпелдә	V
япкыч	N
термостат	N
турбина	N
электромотор	N
туа-тумыштан	ADV
ирокез	N
үпкә-сапка	N
фашизм	N
трахея	N
шуңа	ADVV_NEG
тарлык	V
дәвер	N
гусеница	N
алды-арты	N
циклла	V
мәхдүм	N
кассета	N
информатор	N
очкынлан	V
ренессанс	N
онкологик	ADJ
секретарь	N
пыхылда	V
сөякчел	ADJ
дьякон	N
систематик	ADJ
зурат	N
гетр	N
гонҗә	N
юмор	N
акайт	V
океанолог	N
типче	V
мим	N
күренекле	ADJ
варисташ	N
гыйльми	ADJ
кылтым	N
алгар	V
фант	N
раслама	N
каел	V
үзенчәлек	N
фәтва	N
кыштыр-мыштыр	ADVV_NEG
этилбензол	N
тынычла	V
халтура	N
гидростанция	N
уйла	V
тәңгәл	ADJ
арыт	V
продуктив	ADJ
парк	N
атаулы	ADJ
айныт	V
поликристалл	N
планктон	N
аумакай	ADJ
пирамида	N
каймык	V
шәүлән	V
тыңла	V
сал	V
детектор	N
ясак	N
сентименталь	ADJ
салкынчалык	N
ю	V
кремний	N
төзәйт	V
ампир	N
партиячел	ADJ
үзагым	N
чалка	N
караклан	V
мәслихәт	N
ихтыяҗи	ADJ
гәпләш	V
биага	N
техника	N
мәтрүшкә	N
аристократик	ADJ
укытучы	N
прогностик	ADJ
этнология	N
чебурек	N
хәзергәчә	ADVV_NEG
дәвам	N
йомша	V
фәнниләштер	V
илче	N
дарвинизм	N
мизантроп	N
литер	N
ятакханә	N
романс	N
ландшафт	N
ап	PREF_ULTRA
водолаз	N
кинаялә	V
үрмәлән	V
тиресләт	V
анар	N
китель	N
комар	N
мездра	N
наличник	N
кулса	N
интернат	N
шымыкый	ADJ
анонс	N
өткеч	N
тугым	N
уңла	V
фосфат	N
пантотен	N
барлык-юклык	ADVV_NEG
михнәтлән	V
пародия	N
тиреашар	N
ялгыз	N
нахаллан	V
кичкелек	N
сыек	ADJ
пима	N
таныкнамә	N
Шркәк	N
калибрла	V
кооператив	N
көрәш	V
фенол	N
экспортла	V
тире-яры	N
мәктәп	N
континент	N
ит	N
кулайла	V
аты-юлы	N
һичсүзсез	ADVV_NEG
бозыл	V
ит	V
князь	N
көрәш	N
биш	NUM
каралт	V
гүләт	V
утлавык	N
түп	N
шапылдат	V
җитдилә	V
кассия	N
якшәмбе	N
листовка	N
казый	N
костыргыч	ADJ
мөшкеллән	V
укшыткыч	ADJ
фермер	N
яшькелт	ADJ
бәләкәй	ADJ
факт	N
талкын	V
җемелдәвек	N
совхоз	N
диалог	N
золым-җәбер	N
минер	N
дөңгердә	V
батист	N
кыйпыл	V
чабын	V
сүренке	ADJ
украин	N
табакла	V
шигый	ADJ
чыгымла	V
сорылан	V
музей	N
эпилептик	N
этап	N
застава	N
эчерт	V
штурмлан	V
лох	N
томаналан	V
өзәлән	V
савыт	N
мөлдерәт	V
пианист	N
берни	PN
кәстәнә	N
кысан	ADJ
сәхнәләштер	V
тас	N
македон	N
кобра	N
таксист	N
нерв	N
мәлҗе	V
лиф	N
үзещән	ADJ
кәнтәйлән	V
ачкыч	N
томана	ADJ
сызган	V
колак	N
уйсу	ADJ
хәнҗәр	N
суыксы	V
чахотка	N
мәшһүрлә	V
ычкындыр	V
кулалмашка	ADV
Шнструмент	N
алмалан	V
уйгур	N
вазелин	N
күнекмә	N
оптимизация	N
педиатрия	N
инсценировка	N
Шмән	N
бактериаль	ADJ
астматик	N
туып-үскән	ADJ
гранит	N
уру-сугу	N
фәһем	N
иркенәй	V
моңдаш	N
мөнафи	ADJ
бакен	N
бәла	N
почет	N
тышау	N
интернациональ	ADJ
тешләклән	V
тещек	N
сатула	V
мышкылда	V
Шмән	V
миткаль	N
ведомость	N
койрыклан	V
үзбелдекле	ADJ
юлбащы	N
бәп	PREF_ULTRA
икмәк	N
янартау	N
вакханалия	N
так	ADJ
юламан	N
экзотика	N
катастрофик	ADJ
чесуча	N
голланд	N
бөлгенлек	N
шәфкать	N
канла	V
җәймә	N
бурала	V
стена	N
идеал	N
тукта	V
сут	N
бурлат	N
үчлән	V
койкала	V
тартым	N
курсант	N
телепатия	N
алдагы	ADJ
кичектерел	V
движок	N
стерильлә	V
либераллаш	V
өзгәлән	V
пирке	N
учетчик	N
иркәлә	V
иркенлек	N
кобаер	N
әвештер	V
идеализм	N
кораллан	V
консервация	N
җепшет	V
капма-каршы	ADJ
исәпләт	V
сагыз	N
койма	N
өс-баш	N
хахылда	V
квас	N
синьор	N
дару	N
мактал	V
төнге	ADJ
ятим	N
аркыла	V
макетла	V
ыжылда	V
пешкәк	V
эрет	V
аналык	N
күке	N
лимонка	N
укытыл	V
замок	N
икенчесе	ADJ
эч	V
бозгыч	N
доктор	N
библиографик	ADJ
физкультурник	N
ли	N
иллюминациялә	V
оппортунизм	N
тарафдар	N
җШт	V
күзмә-күз	ADV
серкәч	N
бионика	N
спиритизм	N
чажылда	V
рух	N
аула	V
городовой	N
талтирәк	N
кан-тир	N
мыжгырда	V
профком	N
шыгырдык	ADJ
эңгер-меңгер	N
кыскар	V
төшенчә	N
радиофизика	N
имитатор	N
тигез	V
информатика	N
картографик	ADJ
озаклат	V
мәшһүр	ADJ
пешкәклә	V
кил	V
илкүләм	ADJ
кушан	V
мистерия	N
терапевтик	ADJ
тайпыл	V
лангуст	N
бернәрсә	PN
хурлат	V
вафля	N
шнур	N
куерт	V
йомылыр-йомылмас	ADJ
киңлек	N
масдар	N
флаг	N
иртәсе	ADVV_NEG
далия	N
гөрзи	N
атлама	N
шәм	N
коточыргыч	ADJ
исәнлек	N
сабандаш	N
чутылдат	V
кердеш	N
диндәш	N
чыжылда	V
алдала	V
кыйраәтханә	N
сюзерен	N
индивидуальләштер	V
вентиль	N
паста	N
шөпшә	N
кысрык	ADJ
суганлы-борычлы	ADJ
телевизор	N
тернәклән	V
башакчык	N
төзәнү-бизәнү	N
уенлы-чынлы	ADJ
дөлдөл	N
покер	N
митрополия	N
поза	N
маркер	N
тибрән	V
әвеслек	N
классификация	N
котла	V
гайрәтлән	V
фин-угор	N
беләүлә	V
мәкәй	N
шүрәле	N
коньки	N
шомландыр	V
пантюркист	N
корей	N
бозлавык	N
култыклан	V
кырпу	N
кабала	V
консерватор	N
бушайт	V
партбюро	N
тума	N
кочакла	V
мол	N
сип	V
молдаван	N
текердә	V
динамит	N
ләтчә	N
туганый	N
соңай	V
наркотик	N
у	N
полкташ	N
мунчалала	V
чибәр	ADJ
диамат	N
у	V
зарлан	V
баса	N
вилдан	N
сарут	N
кисәкчә	N
чылан	V
мимик	ADJ
заявка	N
мультипликация	N
көрти	N
гримаса	N
героика	N
авантюризм	N
дәвала	V
ритмлаштыр	V
йөзгәләк	N
әйдүклә	V
цемент	N
бүлтәймә	N
дворник	N
австралопитек	N
категория	N
кычкыр	V
бөти	N
җШз	N
кирәк-кирәкмәс	ADJ
брошка	N
базилик	N
берән-сәрән	ADVV_NEG
кулланма	N
туберкулез	N
капот	N
дебет	N
аттракцион	N
таксомотор	N
провокация	N
тузын	V
чыркылдык	N
давыллан	V
парашют	N
блиц	N
соль	N
криминалистик	ADJ
терпе	N
чаңгы	N
эрготизм	N
нигезсез-нисез	ADJ
фанер	ADJ
Шслә	V
чәпчет	V
оек	N
агрессия	N
лексема	N
кутырла	V
лекция	N
кыек	ADJ
зәйтүн	N
клиника	N
пәри	N
гормональ	ADJ
амальгама	N
тәрбияләт	V
муаффәкыять	N
лыпырдат	V
вагранка	N
азапла	V
турам	N
ватан	N
бәйләт	V
уйнак	ADJ
кыйна	V
карст	N
терма	N
таҗгөлчә	N
бШ	N
чәчән	N
кулай	ADJ
шикмә	N
әтмәллә	V
шешенке	ADJ
юмакай	ADJ
низаг-талаш	N
анероид	N
кәрәзлән	V
стоп-кран	N
яратыл	V
кечкенәлек	N
сатирик	N
грим	N
игенлек	N
гангстер	N
тумыштан	ADV
җиде	NUM
акырын	V
маркала	V
чәпәт	V
чөмер	V
социализация	N
лабиринт	N
махист	N
эскәтер	N
комык	N
доберман	N
флигель	N
милитаристик	ADJ
селкет	V
мутант	N
киселмә	N
шампан	ADJ
тамаксау	ADJ
шундук	ADVV_NEG
сынал	V
шүрлә	V
мавритан	N
чәчел	V
иркәлән	V
пәнҗешәмбе	N
кофта	N
ыштыр	N
эксперименталь	ADJ
пумала	N
укмаш	V
метрик	ADJ
тураклат	V
автопокрышка	N
байтал	N
мактанчык	ADJ
толуол	N
меморандум	N
тезаурус	N
кулазак	N
бәйләвеч	N
тумас	ADJ
шаяр	V
каганат	N
смета	N
сөйлән	V
подписчик	N
беразга	ADV
сакаула	V
пушнина	N
амплитуда	N
шыксызлан	V
метонимия	N
эләктер	V
кичектергесез	ADJ
эвен	N
өф	ADV
плевра	N
уңайлан	V
кал	V
шлягер	N
аркылы	ADJ
лазем	ADJ
янтайт	V
үгетлә	V
җШк	V
чиле-пешле	ADJ
тәфсиллә	V
кукиш	N
коллекционер	N
лазарет	N
пломбир	N
макродөнья	N
официоз	N
палатальлә	V
бурзай	N
рубероид	N
кагыл	V
былбыл	N
индивидуум	N
тавышйоткыч	N
пичәт	N
алдагыч	N
йолала	V
процедура	N
чебеш	N
кремла	V
йон-ябага	N
систематика	N
сарысу	ADJ
лачма	ADV
нишлә	V
ләң-ләң	ADV
бел	V
оратория	N
янәшә	PN
вирус	N
кремль	N
навигатор	N
ката	N
ихтилаф	N
микроскоп	N
плацдарм	N
итләчлән	V
фразер	N
раштуа	N
лыгырдавык	ADJ
телгәлән	V
тотрыксызлан	V
күңеллелән	V
иңбаш	N
сүндер	V
күкебаш	N
хата	N
дукат	N
мазурка	N
призывник	N
мексикалы	N
җилкә	N
дикообраз	N
гарантиялән	V
түземсезлән	V
өртел	V
сукалан	V
камыр	N
яшеллән	V
кысалы	ADJ
манчы	V
җәмгыять	N
сусат	V
тукы	V
чагала	V
квартал	N
колакса	N
әдәплә	V
психиатр	N
сау	ADJ
сейф	N
үтмәслә	V
кабарчык	N
копал	N
төче	ADJ
ләңгелдә	V
комаяк	N
җансызлан	V
караяк	N
мобиль	ADJ
җиңгә	N
яһүди	N
караш	N
әфьюн	N
сүлпән	ADJ
бәй	N
кыланчык	N
куркыныч	ADJ
корткыч	N
тын	V
өметләндер	V
дистиллят	N
турка	N
матроска	N
зажигалка	N
бурлак	N
мазарстан	N
дуңгыз	N
Шңеләй	ADV
чорна	V
сеңдер	V
сөрән	N
федерализм	N
Шсәнлә	V
ычкыр	N
тын	N
сырма	ADJ
үрмәләт	V
лалә	N
төреклә	V
күнектер	V
бүрт	V
либерал	N
зыялы	N
парлан	V
ярык	N
галета	N
мәләк	N
адымла	V
пианола	N
реваншизм	N
запонка	N
сөмбел	N
кайтарма	ADJ
кавем	N
дезинфектор	N
алгыса	V
тамак	N
агроном	N
эзәрлеклә	V
котырт	V
сургучла	V
кәпрәйт	V
кубан	ADJ
плакат	N
үлчә	V
тарихлы	ADJ
каезлат	V
квинтет	N
инстинктив	ADJ
штакетник	N
тыкылда	V
дүртьюллык	ADJ
исбатла	V
стихиячел	ADJ
кычкырын	V
лачкылда	V
фәза	N
кымырҗыт	V
шаһит	N
истисна	N
мәҗбүрият	N
бухта	N
вермахт	N
тематика	N
үрче	V
эклектик	ADJ
суд	N
капремонт	N
феодал	ADJ
яңар	V
япьтәш	N
миниатюра	N
дәхел	N
куерык	ADJ
яхшыр	V
номерла	V
яңарт	V
кадмий	N
развод	N
становой	N
сирәклән	V
сальдо	N
преамбула	N
яшә	V
гөнаһлан	V
эшлән	V
хат	N
яткылык	N
ленд-лиз	N
төртел	V
терек	ADJ
зәңгәрсу-көрән	ADJ
сексуаль	ADJ
карбол	N
антитеза	N
шөһрәт	N
һичтуктаусыз	ADV
комлан	V
чайкал	V
цинга	N
каенсар	N
чормавык	N
эрозия	N
япон	N
мәл	N
туплама	N
чыбыркылат	V
витраж	N
директив	ADJ
мотивация	N
бераз	ADVV_NEG
кызык	ADJ
эрудит	N
көчлелән	V
формулировка	N
кәфенлән	V
башкар	V
палач	N
каурый	N
куышла	V
вассал	N
кюветка	N
репродукциялә	V
шаланда	N
төят	V
пәрәвез	N
баскычла	V
андагы	ADJ
дистә	N
ур	N
капсула	N
балдыз	N
имитациялә	V
гувернантка	N
косметик	ADJ
тот	V
ашлат	V
кондыз	N
инерция	N
хастаханә	N
ту	V
кыста	V
төшлән	V
код	N
полководец	N
карп	N
кузла	N
яна	V
клапан	N
кыздыргыч	ADJ
секретер	N
гыйбарә	N
бәхәс	N
чайка	V
яхшатлы	ADJ
мәдәнилә	V
колга	N
товаровед	N
төчелән	V
бетер	V
портрет	N
биредәге	PN
сыргак	N
гөрелдә	V
мәгарә	N
таян	V
ор	V
трагик	ADJ
нукта	N
контрибуция	N
оятсызлан	V
каезла	V
де-факто	N
ведомство	N
скульптур	ADJ
балкон	N
призма	N
хушбуйла	V
исбат	N
түш	N
тозла	V
куыр	V
контейнер	N
кода-кодачалар	N
грация	N
йөртел	V
протекция	N
фәхешханә	N
юлчабар	N
тарткыч	N
барда	N
автограф	N
спрут	N
нафталин	N
синология	N
мнемотехника	N
триада	N
сөрмәлән	V
имза	N
керосин	N
атеистик	ADJ
дюна	N
чыбыркылан	V
тәфсил	N
артыксын	V
канун	N
тирбәт	V
кыекча	N
какшаулы	ADJ
мелодик	ADJ
мәркәз	N
әфсен	N
россиян	N
өркәч	N
тутык	V
богаулан	V
сискәндер	V
клип	N
кимсен	V
приют	N
ручка	N
мальтоза	N
машинист	N
юнәлдер	V
тәмлән	V
шылдыра	V
йомыш-юл	N
яткын	ADJ
таңсу	N
шпионка	N
шаштырдат	V
дюйм	N
шеш	N
былтыр	ADV
кунача	N
мактаулы	N
кипшер	V
радиотапшыру	N
шарж	N
әкренәй	V
градус	N
тотанак	N
уйгыр	N
бизе	V
кул	N
өзек	N
шеш	V
чытыклан	V
урын	N
җофар	N
диагностик	ADJ
кын	N
мандат	N
кукрай	V
кубар	V
ансын-монсын	PN
холоп	N
деноминация	N
зиһенлә	V
социалист	N
профессура	N
кой	V
чуак	ADJ
чат	N
сценарист	N
меңәрләгән	ADJ
борай	N
җәллад	N
финна	N
озайткыч	N
үзаң	N
кактөш	N
мизан	N
сарай	N
багышлат	V
йоклаткыч	N
гаугалан	V
сайга	N
атаклы	ADJ
тәкәрлек	N
фламанд	N
селитра	N
маемлат	V
кыйшайт	V
готика	N
биограф	N
үп	V
пешерт	V
Шләмән	N
бөркәвеч	N
бербуын	N
деколонизация	N
төрләндергеч	ADJ
тенниска	N
тәрҗемәлә	V
я	N
улат	V
тотакла	V
филармония	N
Шсәр	N
бырла	V
көпкә	N
санчасть	N
тубырла	V
кыекбаш	N
срок	N
пляж	N
петиция	N
богыл	N
патронташ	N
соран	V
белдерел	V
кучкыллан	V
татар	N
постпозитив	ADJ
диссидент	N
җирдәш	N
мырылда	V
прәннек	N
токсик	ADJ
этаж	N
септет	N
автокран	N
кечуа	N
газель	N
очлан	V
авырсын	V
кыркыл	V
шуннан	PN
кысрыкла	V
транспортер	N
капчык	N
умыр	V
ку	ADJ
шарт	N
штукатурка	N
тамга	N
комиссия	N
ияртем	N
чирт	V
суккала	V
җилләткеч	N
шыпырт	ADV
импровизация	N
торф	N
ләүхә	N
фауна	N
прогрессия	N
камилла	N
бригадир	N
әрче	V
кичен	V
корбан	N
эвакуациялә	V
сайланчык	N
пласт	N
беркөнне	ADVV_NEG
сменадаш	N
йончык	V
ничәмә-ничә	ADV
актарыл	V
митрополит	N
тШңдәш	ADJ
гөмбәз	N
анархия	N
кушканат	N
расчет	N
вакыт	N
трибуна	N
мән	PN
тыенкы	ADJ
колмак	N
маңка	N
котырык	N
баранка	N
суыр	V
дүртәүләшеп	ADJ
уполномоченный	N
хәтер	N
сәйлән	N
кытырда	V
ревизия	N
үткенәй	V
элдер	V
Шкән	PN
укмаш	ADJ
эпиграфика	N
миһаһайла	V
үзагач	N
карабүрек	N
тиш	V
тырылдык	N
нәҗеслән	V
ласт	N
күлмәк-ыштан	N
ашыгыч	ADJ
технократ	N
дәфга	N
патриархат	N
чиклән	V
кобзарь	N
саплат	V
бәян	N
мәдәни-агарту	ADJ
тәпкелә	V
депрессия	N
идеология	N
гүрстан	N
өтерге	N
академик	N
хәл	N
каптыр	V
коммерция	N
сатыл	V
эшлә	V
изрә	V
рецептура	N
кыптырда	V
таякла	V
варьете	N
хасиятлән	V
мөрәҗәгать	N
паратиф	N
шыңгырдат	V
мәдәни	ADJ
астроном	N
абрикос	N
очла	V
үткенәйт	V
имлә	V
ни-нәрсә	PN
оялт	V
кардиограмма	N
көя	N
контрамарка	N
шөбһә	N
почмак	N
шарайт	V
шиңгән	ADJ
нәрсәлек	N
причал	N
атавистик	ADJ
палтус	N
гантель	N
тетрәндергеч	ADJ
зефир	N
өскорма	N
кырыкма	ADJ
әллә-әллә	CNJ
сусыл	ADJ
гөрәнкә	N
император	N
келәм	N
управдом	N
зоотехник	N
кармала	V
пирог	N
торшер	N
буразнала	V
икенчелән	V
артистлан	V
мандрагора	N
төпләмә	N
дәрман	N
экзарх	N
күкбүз	ADJ
һиҗрәт	N
психолог	N
тәүлек	N
тәнкыйть	N
алҗы	V
сала	N
ректорат	N
чырылда	V
кудыргыч	ADJ
лигнин	N
чүпрәк	N
мистика	N
шупыр	V
бервакыт	ADVV_NEG
артефакт	N
сыешлык	N
харап	ADJ
автордаш	N
дошман	N
фолиант	N
көмән	N
зал	N
ат-тун	N
атрофия	N
сыптырт	V
явызлан	V
романтика	N
аннан	ADV
яра	N
кырыгы	N
яра	V
штольня	N
чачаклан	V
шөбһәлән	V
октябрят	N
җинаять	N
винтовка	N
янтык	N
чәрелдәт	V
күгәрен	V
кыяфәт	N
ветеринар	N
Шген-ашлык	N
лыбырдык	N
уен-җыр	N
пәһлеван	N
тутый	N
бишкөнлек	N
тартык	ADJ
кәҗәлән	V
авиалиния	N
чалыш-чолыш	ADJ
татарчалат	V
тупа	ADJ
телән	V
инфинитив	N
контр	N
каллиграфия	N
илхан	N
гүяки	CNJ
лачма	ADVV_NEG
текә	ADJ
морза	N
биләм	N
җит	V
тәгәрмәч	N
иплән	V
рупор	N
ындыр	N
бамбук	N
вестовой	N
мыштырда	V
гуманистик	ADJ
насос	N
ода	N
континуум	N
такта-токта	N
Шртән	ADV
лев	N
дача	N
режиссер	N
мәҗнүн	N
кәрван	N
иркәм	N
трубадур	N
кызулат	V
берәгәйле	ADJ
песнәк	N
оригинал	N
радиотапшыргыч	N
сакал	N
йомыл	V
сенаж	N
автор	N
гөлчәчәк	N
чүп-чарла	V
манипулятор	N
шырпы	N
сәдәплә	V
ялбыр	ADJ
пыт-пыт	ADV
телефонистка	N
карык	V
вето	N
эллипс	N
бөкрелән	V
предлог	N
сумма	N
тормыш	N
гакыллы	ADJ
чеп-чи	ADJ
әтәлге	N
йомыклан	V
камыл	N
түтәл	N
байбикә	N
аннотация	N
самбо	N
яланөс	ADVV_NEG
чәкүшкә	N
валокордин	N
бакрач	N
дипломатик	ADJ
заочник	N
лейкоцитоз	N
вегетариан	N
хурҗин	N
зәнҗәбил	N
нөсхә	N
авторитар	ADJ
төшен	V
киноактриса	N
ярпач	ADJ
солидол	N
монолит	N
эпидемик	ADJ
пилотаж	N
пиастр	N
иңгән	ADJ
истигарә	N
алкалоид	N
гүя	CNJ
аксат	V
төкчә	N
фиорд	N
пестә	N
ислемай	N
микродөнья	N
оккупант	N
тупла	V
метрополитен	N
рецензия	N
акыл	N
сырпала	V
исле	ADJ
төкән	V
куе	ADJ
сюрреализм	N
марсельеза	N
чирекфинал	N
әләк	N
бәләкәч	N
тамыр	N
күтәренке	ADJ
счетчик	N
закон	N
давылла	V
порнография	N
кенәгә	N
декрет	N
метр	N
каңгы	N
марсиан	N
куәт	N
йолдызла	V
турун	N
бормалан	V
русчала	V
эластик	ADJ
камуфляж	N
төчкерек	N
Шмза	N
технология	N
бортинженер	N
очан	N
фильмоскоп	N
каноник	ADJ
батрак	N
кавык	N
катализатор	N
сварка	N
материалла	V
таблица	N
толмач	N
мутация	N
пәже	V
конфетлан	V
зур	ADJ
четерек	ADJ
гуманитар	ADJ
сәрви	N
каезлама	N
пианистка	N
миксер	N
мөмкинлек	N
инҗир	N
реглан	N
галош	N
персик	N
сүзмә-сүз	ADV
ун	NUM
капыл	ADVV_NEG
маймыл	N
фальсификациялә	V
ваем	N
җебек	ADJ
бөтерчек	N
реализация	N
ыслан	V
фантастик	ADJ
калькала	V
фотосөюче	N
сыгын	V
сонор	N
иерархия	N
абстрактла	V
ир-хатын	N
сазлан	V
кырыгышар	N
ку-клукс-клан	N
вокалист	N
бибколлектор	N
чуалт	V
чебен	N
берсүзсез	ADV
планер	N
буян	V
картай	V
ягымлылык	N
ыңгыраш	V
эре	ADJ
әмәллә	V
юкәлә	V
крестьян	N
төнтеклән	V
авиация	N
чагылдыр	V
кыпчак-угыз	N
олай	V
альманах	N
капу	N
туплат	V
иртәдән	ADV
мәйданчык	N
комедия	N
биоток	N
кагыйдә	N
материалист	N
көньяк-көнбатыш	N
торыш-килбәт	N
фикерлә	V
фил	N
кыргыйла	V
бае	V
прокуратура	N
сүтелгән	ADJ
былтыр	ADVV_NEG
парткомиссия	N
интурист	N
бәйрәм	N
тозлат	V
чишен	V
яшьлән	V
аршын	N
мыгырдавык	N
нан	N
саркыт	V
Шртәгәдән	ADVV_NEG
оча	N
флюгер	N
вобла	N
капитуляциялән	V
маскхалат	N
интенсивла	V
маркиз	N
путевка	N
кама	V
әшәке	ADJ
шаркылдык	N
бирле	POST
дирбия	N
әңгәмә	N
пропорция	N
бытбылдык	N
уң	V
сасык	N
сагышлан	V
каторжан	N
комсомолия	N
җырлат	V
гелий	N
Шмәнеч	ADJ
ың-шың	N
чыкылда	V
тыш	N
тыкылдат	V
тустаган	N
тупырда	V
сасы	V
албан	N
параличлан	V
узын	V
столяр	N
ябынгыч	N
невроз	N
ансатла	V
раковина	N
системала	V
иңеләй	ADV
ябагай	ADJ
пункт	N
атна	N
малярия	N
алмаштыргысыз	ADJ
бетмәс-төкәнмәс	ADJ
химияләштер	V
җиңеллә	V
привилегия	N
ымла	V
капиталист	N
истребитель	N
Шртәдә	ADV
нигилист	N
лото	N
ленинизм	N
күсәк	N
эпидиаскоп	N
штамм	N
карантин	N
меланж	ADJ
слюда	N
чыңгылдат	V
оер	N
агитпункт	N
биометрик	ADJ
күбесе	N
чокчын	V
шадра	ADJ
кельт	N
бәлтерә	V
татлылан	V
гамбәр	ADJ
бургомистр	N
чәберчеклән	V
какчалан	V
зәңгәрсу	ADJ
бүлекчә	N
литфонд	N
чыда	V
бәкәл	N
метраж	N
чалкан	ADVV_NEG
карсак	N
илтимас	N
афиналы	N
сыйлат	V
якорь	N
бюрократла	V
кәйтән	N
лавра	N
темперамент	N
тимерташ	N
тәрбиялән	V
мышкылдат	V
аягүрә	ADV
Шмез	V
масон	N
Шнсаф	N
травматолог	N
миллиционер	N
түлән	V
бүлен	V
ватык	ADJ
зоология	N
әбШ	N
кырынгыч	N
өйләндер	V
сейм	N
чыпчык	N
чШбәр	ADJ
сайланма	N
чәчәк	N
нигилистик	ADJ
карьера	N
бәйлән	V
ихласлан	V
фаталистик	ADJ
чан	N
актер	N
һичсүзсез	ADV
зобани	N
конвент	N
тырын-тырагай	ADV
ярпай	V
төрбә	N
иснән	V
йоткылык	N
фәнни-техник	ADJ
штамповкала	V
игезәк	N
төймәлән	V
күргәзмә	N
логик	ADJ
расходлан	V
черегән	ADJ
банан	N
бойня	N
чокырчык	N
чибәрлә	V
серпантин	N
тип	V
дәрәҗәлә	V
авиамодель	N
аһәңдәш	N
сотрудник	N
савыктыргыч	ADJ
бугалак	N
комбисилос	N
миңгерәүләт	V
каста	N
берәмлек	N
пәрдә	N
җәфала	V
өшкерү-төкерү	N
бишбармак	N
кино	N
көндез	N
нәзберек	ADJ
карган	V
йомры	ADJ
ялагайлан	V
тимерчыбык	N
төягеч	N
кыпчак	N
из	V
комиссионка	N
рейдер	N
кесәбикә	N
эпизодик	ADJ
Шнәкә	N
этәр	V
ярымтүгәрәк	N
мәлҗерәй	V
рухландыргыч	ADJ
гильдия	N
юрт	V
сигнал	N
лоция	N
төтәткеч	N
геофизик	N
гипнозла	V
пантеистик	ADJ
налет	N
гомогенлык	N
әбрәкәй	N
валчык	N
керәшә	N
кыбырсык	N
максималь	N
надан	ADJ
сөйкемле	ADJ
лотос	N
әз	ADJ
тагыл	V
бинтла	V
җиһазла	V
мавык	V
конфорка	N
ялкыт	V
будда	N
керделе-чыктылы	ADJ
юыл	V
сөйкә	V
буя	V
иртәгә-берсекөнгә	ADV
номер	N
азык	N
нәүмизлән	ADJ
ми	ADJ
терминология	N
сарыбаш	N
хәл-әхвәл	N
әйләнәли	ADVV_NEG
аборт	N
сөяк	N
имгеч	N
кырыс	ADJ
борат	N
альбумин	N
интендант	N
гигантизм	N
бимаза	N
дәһшәт	N
кадавыч	N
канатла	V
лапылда	V
яндыр	V
лаз	N
ләгыйнь	N
триумвират	N
конфедератив	ADJ
тимол	N
лаякыл	ADVV_NEG
камал	V
дилемма	N
мензурка	N
авыргала	V
граммофон	N
панама	N
озынай	V
сәламәтләндер	V
паспортлаштыр	V
камытла	V
фугас	N
терелән	V
материалистик	ADJ
дустанә	ADV
охша	V
румб	N
синдикат	N
карачай	N
дускай	N
юрисконсульт	ADJ
менгез	V
ремонтлан	V
тилелән	V
динамомашина	N
чүл	N
коньяк	N
хисаплан	V
ләп	ADVV_NEG
тезгенлән	V
аңлашылмастай	ADVV_NEG
эпиграф	N
кыегай	V
лафа	N
атнакөн	N
атама	N
табу	N
сизел	V
салмаклан	V
катла	V
балл	N
оптимистик	ADJ
фотожурналист	N
поляр	ADJ
трахома	N
кинолента	N
энҗе	N
болытла	V
политехника	N
шкипер	N
тектоник	ADJ
арын	V
көйләгеч	N
акса	V
гот	N
координациялә	V
төпсә	N
марҗа	N
кыенсын	V
әнәчә	N
ион	N
кешәнлә	V
пырла	V
тоемла	V
күзлут	N
Шнтерьер	N
апелляцион	ADJ
психология	N
чегән	N
афиша	N
селтән	V
шарада	N
дә	CNJ
тупыйк	ADJ
мөддәт	N
югалмастай	ADV
эшафот	N
япан	N
лиризм	N
яраула	V
көймә	N
тонна	N
тырмавыч	N
сүнек	ADJ
мотор	N
авыз-борын	N
микрон	N
аппликация	N
абонемент	N
лычкылдат	V
почтмейстер	N
континенталь	ADJ
мыштыр	ADJ
карбоксил	N
ялкылда	V
пигмент	N
җирлән	V
тис	N
тугай-тугай	ADJ
киртек	N
электрокардиограмма	N
мич	N
бөркет	N
гөреҗдә	N
исәплән	V
айгыр	N
миноносец	N
инверсия	N
периодик	ADJ
бургунд	ADJ
оптимистлык	N
коми	N
гипнотизер	N
тиран	N
тернәк	N
чәнче	V
кебек	PN
гетто	N
кондуктор	N
тевтон	N
бөдрәлән	V
очкыч	N
яргалан	V
кайтышлый	ADVV_NEG
гыйффәт	N
әштер-өштер	ADVV_NEG
тамызгыч	N
бетонла	V
бижутерия	N
ләкаб	N
фасыл	N
өлгер	V
батарея	N
йөзем	N
эротик	ADJ
көш	N
видеотелефон	N
Шзала	V
нутрия	N
җаһил	ADJ
чырылдавык	ADJ
рәвеш	N
карамель	N
Шнсульт	N
комбинатор	N
гражданка	N
сып	PREF_ULTRA
үзара	ADV
бастырыкла	V
көяләк	N
абрек	N
корал	N
зинһарлап	ADVV_NEG
актриса	N
оригиналь	ADJ
гаскәри	N
гареш	N
ателье	N
фонологик	ADJ
бакча	N
индивидуалист	N
сил	N
буа	N
көр	ADJ
кондиционер	N
телестудия	N
фикри	ADJ
шамакайлан	V
бурлы	ADJ
дөньяви	ADJ
юмористик	ADJ
тиктормас	ADJ
аһ	ATTR_ABES
автопарк	N
регресс	N
катлау	N
теософия	N
фонтан	N
лимфа	N
специфик	ADJ
гидробиолог	N
өлге	N
сургыч	N
гөбердә	V
генеалогик	ADJ
мәрхәмәт	N
тезем	N
кач	V
өзлек	V
медпункт	N
көйлә	V
сулагай	N
мыек	N
сыт	V
лебердә	V
иртәнге	ADJ
этимолог	N
финиш	N
лассо	N
тәртип	N
авызлан	V
яланбаш	ADJ
кинотеатр	N
ыңгырчак	N
медиум	N
йолым	N
талгынлан	V
стерилизатор	N
бөстан	N
үзаралай	ADV
астрономик	ADJ
кузырлы	ADJ
пролетариат	N
фәрештә	N
Шс	N
анестезиялә	V
як	N
ук-җәя	N
Шс	V
як	V
секундант	N
төче-мөче	ADJ
офтальмология	N
прецедент	N
пикет	N
уел	V
селте	N
бетәш	V
хинин	N
преферанс	N
валун	N
балкылда	V
шпион	N
билбау	N
гайре	ADV
кыңгыр	ADVV_NEG
нисби	ADJ
тиражла	V
сопрано	N
тасвирлан	V
виола	N
сигезаяк	V
юындыр	V
клизма	N
командир	N
җорла	V
кушыл	V
тәбикмәк	N
обоз	N
Шкейөзле	ADJ
ризалат	V
суфи	N
эндәш	V
лап	ADVV_NEG
штрихла	V
туен	V
чәркә	N
стаж	N
өзлексез	ADJ
бизгәк	N
тынсыз-өнсез	ADJ
инвариант	ADJ
бәдәви	ADJ
ананас	N
фриз	N
ихтиозавр	N
аббат	N
шугала	V
өсйөз	N
урталай	ADV
диафрагма	N
чуваш	N
тияр	ADJ
экзальтация	N
руль	N
пеләшлә	V
түшәлмә	ADJ
контратака	N
ловелас	N
үлчәгеч	N
фән	N
индус	N
лоток	N
көйсезлә	V
уенчак	ADJ
алдакчы	N
ип	N
кентавр	N
анод	N
карамчык	N
тутырт	V
телефонограмма	N
районара	ADJ
акрынай	V
икенчеләт	V
нәүбәт	N
эфес	N
нечкәрт	V
пеләш	ADJ
дарулан	V
симез	ADJ
биз	N
керогаз	N
сөннәт	N
ярсулан	V
комкорсак	N
теология	N
биз	V
фотоиллюстрация	N
рентген	N
метеор	N
бырылда	V
тынычсызлан	V
комачау	N
нәдербаш	N
ни	N
гошер	N
батун	N
гали	ADJ
түмәр	N
иртәнгәчә	ADV
лосьон	N
зурайткыч	N
күпмилләтле	ADJ
борынгы	ADJ
сәгать	N
докторантура	N
әбәк	N
деморализация	N
гаҗизлән	V
вуз	N
минерал	N
җигел	V
тапта	V
вкладыш	N
штурм	N
матавыклан	V
арка	N
юшкә	N
коймакла	V
бройлер	N
антициклон	N
тыракла	V
мәшәкатьлә	V
кола	ADJ
беравыздан	ADVV_NEG
бактерия	N
универсал	N
смокинг	N
финикияле	N
люкс	N
шкаф	N
агымлы	ADJ
пединститут	N
эремчек	N
ларек	N
кыҗра	V
яртылаш	ADVV_NEG
шампунь	N
иртәләрен	ADVV_NEG
гыйшык	N
ясат	V
мәкәрҗә	N
ташлагыч	N
компания	N
и	N
борма	N
радиола	N
йомычкала	V
масштаб	N
эскалатор	N
дилогия	N
микрокосмос	N
казала	V
сөаль	N
хокук	PN
корымлан	V
мендер	V
алан-йолан	ADVV_NEG
лента	N
бәхиллек	N
тыловик	N
догмат	N
киндер	N
фаза	N
без	N
ташпулат	N
каршыдаш	ADJ
консультация	N
шуңарчы	PN
илсез-йортсыз	ADJ
физкультура	N
хәмер	N
конспирация	N
дәрәҗә	N
теткәлән	V
вокаль	ADJ
намаз	N
килү-китү	N
Шшек	N
яртылай	ADVV_NEG
коттедж	N
пот	N
мәлҗерәт	V
телепрограмма	N
тарай	V
камчадал	N
хроник	ADJ
михнәт	N
параллель	N
акканлылык	N
катион	N
гарыс	N
крейсер	N
ырым	N
тырнан	V
җиксет	V
икс	N
информатив	ADJ
мәзәксен	V
ялантау	N
романтик	ADJ
кап	N
зиярәт	N
шыртлат	V
тилмерт	V
оп	PREF_ULTRA
тоткарлык	N
ай-көн	N
саргылт-кызыл	ADJ
лига	N
тоттыр	V
сыен	V
кыенсыт	V
разверстка	N
акыр	V
тротил	N
зебра	N
арула	V
кадал	V
корма	ADJ
хас	ADJ
семантик	ADJ
файда	N
мөлдерә	V
кичлә	V
кытыршыла	V
метод	N
автострада	N
егерь	N
михнәттәш	N
антидөнья	N
реставрация	N
туфани	ADJ
мельхиор	ADJ
партколлектив	N
гидробиология	N
чеңлә	V
мәкаль	N
гурт	N
арзанайт	V
абзый	N
турылат	V
өшегән	ADJ
тәмләткеч	N
телевышка	N
фотографик	ADJ
һәйкәл	N
плазмоцид	N
прокат	N
микрорайон	N
телескоп	N
анекдот	N
аллегория	N
диалект	N
каденция	N
кислота	N
куш	V
беравык	ADV
иртәгәдән	ADV
садизм	N
бакылдык	ADJ
шөлдер	N
тәбе	N
хулиганлан	V
бота	V
фәнни-популяр	ADJ
сәмруг	N
анизол	N
яланөс	ADV
җәзалат	V
кыйма	V
сөйрәт	V
өй-каралты	N
чыжла	V
декоратив	ADJ
слесарь-сантехник	N
шау	N
бином	N
күтәртмә	N
Шхлас	ADJ
ялвар	V
сырганак	N
тегәлә	V
крахмалла	V
тумпак	N
кашыт	V
хронология	N
кыңгыра	V
суккалан	V
юкабаш	N
ме	N
герман	ADJ
үзгәртел	V
бет	N
пастеризациялә	V
статус	N
сажинла	V
мимылдат	V
флюорография	N
комментарий	N
сүк	V
аслы-өсле	ADJ
яргак	N
тымызыклык	N
епископ	N
һинд-европа	N
яме-тәме	N
бет	V
уемтык	N
сөннәтләт	V
яндыргыч	ADJ
хлоралгидрат	N
хор	N
гомумаңлаешлы	ADJ
тегәрҗеп	N
биниһая	ADV
импорт	N
фильм	N
фанера	N
борыл	V
типикла	V
компост	N
колодка	N
кофейник	N
макрокосм	N
диапазон	N
тотнаксызлан	V
атташе	N
хакас	N
катгый	ADJ
ау	V
тоҗра	V
карчыга	N
пункция	N
чынык	V
ти	V
казенный	ADJ
чәйнек	N
дәррәү	ADVV_NEG
тотрык	N
урын-җир	N
төңгер	N
күчәр	N
алпан-тилпән	ADVV_NEG
чекерәйт	V
ау	N
каплун	N
авызлыкла	V
яфракчык	N
чут	N
партитура	N
геронтология	N
хәдис	N
сөнни	N
футболка	N
предмет	N
чолган	V
миңгерә	V
сходка	N
электерел	V
штангенциркуль	N
шайтан	N
паренхима	N
комментатор	N
Шңсә	N
алынма	N
социализм	N
мыркылда	V
көньяк	N
бәлҗерә	V
чиге-кырые	N
штык	N
туйгысыз	ADJ
куркак	N
шомрай	V
интернационализм	N
сират	N
идарә	N
борчала	V
генерал	N
кальций	N
солярий	N
алдынгы	ADJ
попугай	N
финансист	N
лингвист	N
хәстә	N
галип	N
шакырда	V
чуртан	N
көлдер	V
сикер	V
проза	N
фотокопия	N
капшавыч	N
туксан	NUM
бурсык	N
акт	N
адекват	ADJ
күптин-күп	ADVV_NEG
җәмәгать	N
колынчык	N
биклә	V
туфрак	N
әхлакый	ADJ
сәрдә	N
таныл	V
стилистик	ADJ
кабил	N
куыклан	V
американ	N
рекрут	N
часть	N
шәмрәйт	V
комплекция	N
тип	N
кабилият	N
бәбилә	V
фикрән	ADVV_NEG
ят	V
актуаль	ADJ
аксыргак	N
үтүклә	V
үтәл	V
чатна	V
бирнә	N
гарәфә	N
калай	N
кыйшай	V
метроном	N
әләклә	V
җебе	V
цехком	N
мастит	N
чәршәмбе	N
афера	N
коралдаш	N
ботаник	N
комендатура	N
бисульфат	N
экскурсант	N
фальцет	N
репортаж	N
тез	N
ватандаш	N
генеалогия	N
этәргеч	N
жуылда	V
иртүк	ADV
нәфеслән	V
монитор	N
күт	N
төп	N
җирсе	V
советчыл	ADJ
тез	V
тармак	N
тәмлеләт	V
җиксе	V
күңелчәк	N
январь	N
олигофрен	N
кухарка	N
кызарт	V
түбәнлек	N
полисемия	N
бүләклә	V
чүт	ADV
специальлә	V
тирбәнчек	N
кочаклан	V
космография	N
арка-җилкә	N
баланс	N
няня	N
стШль	N
сарделька	N
асылын	V
септик	N
кыйшык	ADJ
суфлер	N
маркировкала	V
автотүгәрәк	N
бертуктамыйча	ADV
урын-вакыт	N
кортизон	N
кала	N
салдыр	V
җәмәгатьлә	V
баррикада	N
басынкы	ADJ
үз	PN
көрмәл	V
чыбырда	V
үрчет	V
иллюзия	N
ни	V
бәддога	N
пай	N
тетрә	V
анион	N
шәкел	N
сәнгать	N
көнче	N
таптал	V
репертуар	N
ышанмастай	ADV
шаптырда	V
туп	N
дискла	V
ишан	N
кәбаб	N
аз-мазлап	ADV
күбәлә	V
формалист	N
суҗыяр	N
артельлә	V
кәшләкә	N
ассимиляциялән	V
тромбоз	N
протекторат	N
ягымлылан	V
дилбегә	N
монолог	N
юмарт	ADJ
каплам	N
намуссын	V
демократла	V
истикамәт	N
тере	ADJ
претендент	N
комсомол	N
какаду	N
үткенлән	V
гироскоп	N
пластинка	N
сантый	N
төзе	V
тайм	N
этлек	N
белекле	ADJ
ташкүмер	N
дәлиллә	V
итек	N
пос	V
автогенчы	N
ниятлән	V
калкым	N
үтем	N
чыпта	N
кыштыр-мыштыр	ADV
җавапла	V
шарлама	N
чех	N
сәбәп	N
биомасса	N
кулалмаш	V
җимерел	V
антоним	N
ягыл	V
мыжылда	V
автодром	N
интеллигенция	N
мөгамәлә	N
шәрә	ADJ
өзгеч	N
чыгым	N
футуристик	ADJ
ля	N
олысымак	ADJ
иңке-миңке	ADJ
аудитория	N
спонсор	N
антагонист	N
компот	N
панацея	N
чартла	V
васита	N
хихылда	V
обрез	N
низаг-ызгыш	N
тирбән	V
чабаталы	ADJ
инвентарьла	V
катылат	V
буталчык	ADJ
паж	N
югартын	ADV
чөйлә	V
кырыслык	N
еш	ADVV_NEG
скелет	N
коелдык	N
какша	V
невралгия	N
сөз	V
сабын	N
малахай	N
төзәл	V
мескенлән	V
автоматик	ADJ
керосинка	N
кызгылт	ADJ
күзалмам	N
канва	N
хөрмә	N
большевистик	ADJ
кирелә	V
колчедан	N
кырау	N
стенокардия	N
попурри	N
пик	N
церемониаль	ADJ
бриллиант	N
саранай	V
чалым	N
джаз	N
түз	V
зоологик	ADJ
сазан	N
медуза	N
уемты	N
меринос	N
дөрләт	V
регистрация	N
җисми	ADJ
тыпырчын	V
җәберләт	V
нәкышлә	V
социаль-тарихи	ADJ
кунык	N
ирештер	V
гомеопат	N
тапшыр	V
акселерат	N
языл	V
барлык-юклык	ADV
сүнәр-сүнмәс	ADJ
диалектологик	ADJ
турбокомпрессор	N
метатезала	V
өчьеллык	N
циклоп	N
этләй	N
фәхеш	N
чикерткә	N
еш	ADV
кинолог	N
мең	NUM
кампания	N
кылчык	N
туктат	V
конкуренция	N
бишкуллап	ADV
пакетла	V
люк	N
диспетчер	N
мәрсия	N
сәҗдә	N
шифрограмма	N
иярләт	V
шлаг	N
көләчлән	V
эритроцит	N
модус	N
пакус	N
яшьнәт	V
чаңгылдат	V
нык	ADJ
ботулизм	N
чәрелдек	ADJ
әсәрен	V
аптыраткыч	ADJ
гөлбадран	N
гайка	N
доцент	N
ялтыравык	N
система	N
рамазан	N
страховой	ADJ
су	N
магия	N
турШст	N
сәрхушлән	V
шакы	V
деликатес	N
рента	N
маго	N
ялыныч	N
сфера	N
кискенләт	V
глютамин	N
чәшке	N
уйланма	ADJ
фрагмент	N
чөлли	N
хатынша	N
ши	N
калкыт	V
таган	N
этанол	N
бадьян	N
сипкеллә	V
фа	N
вулкан	N
абзар-кура	N
тәте	V
плафон	N
шунда	PN
илле	NUM
чупырдат	V
таблетка	N
эрлән	V
яңабаштан	ADVV_NEG
солыча	N
нокдаун	N
тыгын	V
бушбугаз	N
мүкләк	ADJ
чәйнәт	V
зачетка	N
субстанция	N
нужа	N
аскетизм	N
реализм	N
хис	N
кредитла	V
анатомия	N
бунтарьлан	V
карт-коры	N
аккомпаниатор	N
догма	N
реставрациялә	V
дарелфөнүн	N
аяк-саяк	ADV
җәяү	ADV
комод	N
кенә	POST
аһылда	V
саз	N
чыелда	V
элита	N
крон	N
тансыкла	V
көнлекләп	ADVV_NEG
графала	V
редупликация	N
болдыр	N
цивилизация	N
карымта	N
трактат	N
берчак	ADV
һәвәслән	V
кабырчыклан	V
нәләт	N
фирәзә	N
кыдрачлан	V
кисемтә	N
әйлән	V
куштанлан	V
дельта	N
интеллектуаль	ADJ
капылт	ADV
түмгәк	N
спартан	N
тукран	N
биосфера	N
гражданин	N
тылсым	N
басма	N
шайка	N
омшаник	N
юаныч	N
георгин	N
зекер	N
кизү	ADJ
ваниль	N
инфаркт	N
ташкабак	N
омоним	N
болагайлан	V
никельлә	V
сәхнәдәш	N
титакла	V
ректор	N
төнтек	ADJ
зоопарк	N
табигать	N
кече	ADJ
ликвид	N
орнамент	N
рубильник	N
батынкы	ADJ
таныкла	V
әчетке	N
антенна	N
нәтиҗә	N
гөрлә	V
летаргик	ADJ
телефон	N
боек	V
каркылдык	ADJ
хисси	ADJ
аракы	N
антибиотик	N
примитивизм	N
шамбы	N
алкын	V
пластмасса	N
дөге	N
ачулан	V
ачлык-ялангачлык	N
эпиграмма	N
акватория	N
прообраз	N
тапкырлан	V
уйсыз-нисез	ADV
кыек-мыек	ADJ
җирәнчәк	ADJ
купшак	ADJ
каңгырт	V
каеш	N
моңайт	V
галактика	N
драга	N
автохуҗалык	N
гореф	N
мыгырда	V
реформатор	N
калҗа	N
байгыш	N
апакай	N
фШгыль	N
искитмәлесе	ADV
өт	V
җимеш	N
вал	N
кырчын	ADJ
икенчел	ADJ
чыштырда	V
кошевка	N
моңлы-зарлы	ADJ
җебет	V
тирәнәйт	V
куандыргыч	ADJ
художество	N
кырпы	N
бәлзәмлә	V
экспроприация	N
коммуникатив	ADJ
кышлат	V
продукт	N
уала	V
афишала	V
социал-демократ	N
нәселдәнлек	N
сортировка	N
итагать	N
ятьмә	N
вымпел	N
варяг	N
игәч	N
старшина	N
изар	N
теләнче	N
чырылдат	V
фикус	N
ырылдат	V
утырым	N
никотин	N
зыкы	N
информбюро	N
линейка	N
скульптор	N
кабахәтлә	V
җыйнаклан	V
оперетта	N
атлетик	ADJ
уч	N
пиротехника	N
әтәмби	ADJ
котып	N
ырып-ерып	ADV
ырма	V
режиссура	N
Шсәвән	ADJ
гәрәнкә	N
инцидент	N
хосусыйлаштыр	V
түләт	V
кыюлан	V
наждак	N
әрнет	V
крепость	N
мәргән	N
генераллиссимус	N
конфискациялән	V
шатлан	V
диффузия	N
мелодраматик	ADJ
шпана	N
классик	N
сорт	N
монда	ADVV_NEG
яшәрт	V
сарымсак	N
глицерин	N
шөлдерә	V
катыш	ADJ
соскы	N
музыкаль	ADJ
уз	V
унарлык	N
графит	N
монда	ADV
жонглер	N
ширкәт	N
криминал	N
табиб	N
фрак	N
мимылдык	ADJ
коллектив	N
композициялә	V
фарсы	N
рәнҗетерлек	ADJ
кипше	V
эндокрин	ADJ
үтеч	N
буржуа	N
кара-туры	ADJ
капилляр	N
датчан	N
патшабикә	N
хыянәт	N
суй	V
синьорита	N
программ	ADJ
тупаслат	V
бунт	N
баеш	N
лозунг	N
галактоза	N
тумача	N
армия	N
тугры	ADJ
тынгысызла	V
мафия	N
үзбушаткыч	N
аек	ADJ
җыклан	V
үтергеч	N
туган-тумача	N
соус	N
карбонат	N
хормейстер	N
шәфталу	N
үгез	N
улаклан	V
кирле-мырлы	ADJ
обкатка	N
таҗик	N
йогышсызлан	V
янбаш	N
булдыклы	ADJ
и	ADJ
томалан	V
шешмәклән	V
яса	V
торс	N
баскыч	N
укын	V
ишкеч	N
барельеф	N
төшем	N
и	ADV
бүлгәлән	V
полицейский	N
бөтнек	N
тюк	N
ра	N
эрелә	V
онытыл	V
киртләчлән	V
альтернатива	N
шин	N
ритор	N
җәйпәк	ADJ
сэр	N
гильза	N
кичер	V
беллетрист	N
мөмтаз	ADJ
бәбәй	N
назир	N
тирәнәй	V
кайнарла	V
чәбәкәй	N
тәмәке	N
линогравюра	N
авиаотряд	N
индонезияле	N
янкорма	N
кулон	N
сукыр	ADJ
броневик	N
чыгар	V
кыздырыл	V
ревком	N
гаять	ADV
иңлә	V
фельдмаршал	N
оры	N
охшашлан	V
рәхимсезлән	V
контрһөҗүм	N
көнаралаш	ADV
тыгызлагыч	N
ланка	N
югалган	ADJ
бескозырка	N
тупса	N
куышлан	V
тоел	V
тимгеллән	V
драматизм	N
кыеш-мыеш	ADJ
химкомбинат	N
гонг	N
үтен	V
оккупация	N
та	CNJ
мәмәй	N
тулыла	V
кызылсу	ADJ
экспансионист	N
галл	N
октябрист	N
үрмәләч	N
бомбардировка	N
тәмлелә	V
панегирик	N
утильләштер	V
тайга	N
модернизм	N
йөзәрлек	N
подписка	N
батыргыч	N
рахитик	ADJ
антифашист	N
карнавал	N
кәйфият	N
ватык-җимерек	ADJ
күпче	V
конструктор	N
драматург	N
сылтама	N
зәп	PREF_ULTRA
җилгәр	V
компьютер	N
калкан	N
савым	N
бизәнгән	ADJ
ашла	V
өшкерт	V
сирәклә	V
ункөнлек	N
маршрут	N
кәрванбаш	N
им	V
гаубица	N
төнлә	V
им	N
ту	N
идея	N
управа	N
машиналь	ADJ
төзлә	V
сюжет	N
мифологик	ADJ
тамчыла	V
анестезия	N
чыклан	V
башланыр-башланмас	ADJ
суппорт	N
исерткеч	ADJ
рейтинг	N
бөл	V
укшыт	V
кызчык	N
бикасап	N
бөтенлек	N
рейс	N
чылбырла	V
сәясәт	N
тәбәнәклән	V
йолдыз	N
выжылда	V
көчлә	V
күләгәлән	V
йончыт	V
гегемония	N
терел	V
сантехника	N
факультатив	ADJ
меркантиль	ADJ
бермәлне	ADV
физик	ADJ
библиография	N
мотивлан	V
динго	N
натюрморт	N
өйрәткеч	N
аккомпанемент	N
икетеллек	N
рудиментар	ADJ
марка	N
дан	N
череткеч	ADJ
күгелҗем-саргылт	ADJ
стерилизация	N
артериаль	ADJ
юбилей	N
мунчала	N
нигез	N
чүпрәк-чапрак	N
сарыла	V
локма	N
бертөсле	ADJ
чаң	N
цылаштыр	V
мәслихәтлә	V
санитария	N
албасты	N
детектив	N
якынла	V
инициатива	N
ноктала	V
мулай	V
зифа	ADJ
тритий	N
кинохроника	N
иртәдә	ADV
пролетар	N
бөркә	V
подпоручик	N
чайпалт	V
корректор	N
зодиак	N
фикрән	ADV
гөрелдек	N
бөят	N
комфортабель	ADJ
биредә	PN
имрә	V
өйдәш	N
шатун	N
дивидент	N
дошманлат	V
баягынак	ADVV_NEG
секция	N
экран	N
уентыклан	V
речь	N
метил	N
чистартыл	V
телмәгәй	N
тулгак	N
мәркәзлә	V
эстет	N
схемалаштыр	V
питекантроп	N
Шңсәлә	V
телефильм	N
сандружина	N
электростанция	N
аптыраган-йөдәгән	ADJ
эзтабар	N
бюстгальтер	N
организм	N
калшай	V
макарон	N
торык	N
адресат	N
универмаг	N
шифр	N
йогырт	N
сармат	N
дәлия	N
чайнворд	N
сум	N
теоретик	N
сизем	N
керем	N
төзет	V
кыярак	N
кулбаш	N
монограмма	N
чәрек	N
искитәрлек	ADJ
ал	V
буйлы-сынлы	ADJ
нәсәп	N
штейгер	N
терчән	ADJ
ал	N
этикет	N
лимузин	N
юлбарыс	N
бүгенлек	PN
курорт	N
лексикографик	N
стабиль	ADJ
таракан	N
күләгә	N
дифференциация	N
аристократия	N
семантика	N
каланча	N
лауреат	N
тинтәклән	V
ихтыяр	N
казаки	N
ваксыт	V
эксплуататор	N
олтырак	N
шаярт	V
байка	N
тудыка	N
яптыр	V
лейтенант	N
десерт	N
диван	N
сөр	V
шорты	N
доха	N
кушетка	N
настойка	N
мэр	N
грек	N
акция	N
әйле-шәйле	ADV
тибен	V
кысанлык	N
банкир	N
дож	N
конференция	N
эволюция	N
авар	N
бархан	N
грум	N
борсалан	V
меланхолик	N
термос	N
аксакал	N
компрессор	N
фетнә	N
эрен	N
якын-тирә	N
җиңгәчәй	N
пангерманизм	N
тыща	N
төкереклә	V
карьер	N
диверсант	N
әрмәк	N
саргылтлан	V
сүтек	ADJ
тибен	N
ком	N
сертификат	N
виброскоп	N
штиблет	N
гумус	N
шлюп	N
бак	V
бота	N
карусель	N
кысынкыла	V
сабырсызлан	V
бердәмлек	N
процентла	V
янарчәчәк	N
чаршау	N
премьер	N
латыш	N
түр	N
һөдһөд	N
окказиональ	ADJ
керпе	N
шар	N
тетрәт	V
үзалдына	ADVV_NEG
метафизик	N
куыш	N
агрессор	N
синкретик	ADJ
кыеш	ADJ
агачсыл	ADJ
күзе-башы	N
гариза	N
методист	N
Шз	V
картина	N
паритет	N
алмашла	V
чәмчә	N
алалы-тиләле	ADJ
интеграль	ADJ
колын	N
юеш	ADJ
Шнан	V
кырач	ADJ
кадет	N
табындаш	N
промышленник	N
фармакотерапия	N
күпхатынлы	ADJ
милорд	N
кәбисә	N
чыгарт	V
калҗай	V
үзлек	N
ләмлән	V
чагыштырма	N
тарак	N
уймаклан	V
тәүбә	N
сигарет	N
госпиталь	N
пентагон	N
поскын	N
өсәк	N
партмаксимум	N
юп-юаш	ADJ
коточкыч	ADJ
энциклопедист	N
чабакла	V
спиртовка	N
таң	N
деградациялә	V
күрсәтмә	N
атом-төш	N
кындырак	N
фуга	N
мәзәкчел	ADJ
статик	ADJ
экю	N
лайка	N
пайтәхет	N
өяз	N
креол	N
бораула	V
кинематограф	N
мөһерлән	V
ШхтыярШ	ADJ
вице-губернатор	N
олау	N
аючы	N
образ	N
ныклан	V
челем	N
леопард	N
каудар	ADJ
вилка	N
геральдик	ADJ
кавем-кабилә	N
җенлән	V
карбонарий	N
бүләклән	V
бурят	N
опричнина	N
разведка	N
ремарка	N
чәрдәклә	V
онанизм	N
шнурла	V
фата	N
терелт	V
резиденция	N
тегел	V
ваткыч	N
монафи	ADJ
микросхема	N
форма	N
тура	V
твид	N
шуңа	ADV
корешок	N
интерпретация	N
җылым	N
өстен	ADJ
туткыллан	V
очсызлат	V
ассирияле	N
кактус	N
эзәрлә	V
профессор	N
опиум	N
ылыс	N
гарнитура	N
палаш	N
каклан	V
антипод	N
герблы	ADJ
төмсә	ADJ
корсагаяклылар	N
чатлы-чатлы	ADJ
схематизм	N
промтовар	N
көйлән	V
Шсән-аман	ADJ
багана	N
алаша	N
ягымлык	N
вак	ADJ
корылда	V
аралат	V
морс	N
трельяж	N
тимер-күк	ADJ
миләш	N
ярымүткәргеч	N
шәргый	ADJ
антагонизм	N
яралгы	N
ялган	V
әрмән	N
җаный	N
эмансипация	N
радиодулкын	N
материк	N
гәүдә	N
ялган	N
ареал	N
аз-маз	ADV
шу	V
интеграция	N
рейхстаг	N
зелпе	N
амбиция	N
трест	N
юешләт	V
лом	N
стимуллаштыр	V
казарма	N
капрон	N
популярла	V
овация	N
гүлә	V
үзидарә	N
шаһзадә	N
дуылда	V
партячейка	N
берьяклы	ADJ
чирү	N
матур	ADJ
гидролиз	N
мәдәни-көнкүреш	ADJ
углерод	N
стипендия	N
бүлгеч	N
айгылда	V
виолончелист	N
кайрак	N
сетка	N
голландияле	N
колония	N
түтә	N
өрткеч	N
сытык	ADJ
тизгер	ADJ
каба	V
ди	N
курку	N
модаль	ADJ
мәҗүси	ADJ
мелодика	N
сәләмә	ADJ
иснә	V
синтетик	ADJ
кинескоп	N
аңгыра	N
шаулат	V
онколог	N
беркет	V
инфляция	N
диск	N
афоризм	N
җитәкче	N
конфедерация	N
пыскакла	V
сквер	N
аеруча	ADV
